ACGCCCTCAATGTCAAGGC -> CGCCCTCAATGTCAAGGCG
TTAGCGTTAGCTAGTTGCC -> TAGCGTTAGCTAGTTGCCC
CCAGCTAACTGACGAGTTA -> CAGCTAACTGACGAGTTAC
GCTAGTAAGGAGCTTCGAA -> CTAGTAAGGAGCTTCGAAC
GGCTCCACCACATGGTCAT -> GCTCCACCACATGGTCATC
ATGAGAGCAGTCTTACTTG -> TGAGAGCAGTCTTACTTGT
TCGGCTGCTATTTGTGCCC -> CGGCTGCTATTTGTGCCCG
GGTCCGCGTAGGTTTATGG -> GTCCGCGTAGGTTTATGGA
ATTATTAGGTATTTCAGGA -> TTATTAGGTATTTCAGGAA
TGACGGTAGCTCAGGGCTT -> GACGGTAGCTCAGGGCTTG
TCAGGAATGAGGCATTCCG -> CAGGAATGAGGCATTCCGC
CATTAGAGACTTAGAAGAC -> ATTAGAGACTTAGAAGACG
TAGTCGCCAAATATGGTAT -> AGTCGCCAAATATGGTATA
ACTCGGTCTGGACGTTGCC -> CTCGGTCTGGACGTTGCCT
AGCTTCATAAGACGGCGAT -> GCTTCATAAGACGGCGATG
TTCCCCGTGTGTTGTCCGG -> TCCCCGTGTGTTGTCCGGC
CTCTGACTTAGTATGTGGT -> TCTGACTTAGTATGTGGTA
GGGACTTGACCGACTGGTG -> GGACTTGACCGACTGGTGC
CACAGGTGCCAGCTAACTG -> ACAGGTGCCAGCTAACTGA
AACGACTCAAGCGTATTTT -> ACGACTCAAGCGTATTTTT
GTCGAGACCAAACTGTGGG -> TCGAGACCAAACTGTGGGA
CAAGTGAAGGCGAAGAAGG -> AAGTGAAGGCGAAGAAGGA
TCGTACGGCACTAAGGAGA -> CGTACGGCACTAAGGAGAC
CTGCACTGCAACCGGCGTC -> TGCACTGCAACCGGCGTCA
GCTTCATTTCGAAAAGAAC -> CTTCATTTCGAAAAGAACG
GGAGACCCATAGCTTCATT -> GAGACCCATAGCTTCATTG, GAGACCCATAGCTTCATTT
CATCATCCGAATATTGCTA -> ATCATCCGAATATTGCTAT
GAGCTTCGAACTGCTCTGT -> AGCTTCGAACTGCTCTGTT
CTCGGTTCACCCTTCCGAG -> TCGGTTCACCCTTCCGAGA
GTGTGTTGTCCGGCGCGGA -> TGTGTTGTCCGGCGCGGAC
TCCTGAGCCCACTCCGCTG -> CCTGAGCCCACTCCGCTGA
TTACGGTCGTTTCCGGTCG -> TACGGTCGTTTCCGGTCGA
TCTGTCCCTTCACTGCCGG -> CTGTCCCTTCACTGCCGGT
TTAGAGACTTAGAAGACGC -> TAGAGACTTAGAAGACGCT
GTAAAGACTCGGTCTGGAC -> TAAAGACTCGGTCTGGACG
TATTTCAGGAATGAGGCAT -> ATTTCAGGAATGAGGCATT
GCCCCGACGAGTGTTAGAC -> CCCCGACGAGTGTTAGACG
GACGACGCTATGTTAGGCT -> ACGACGCTATGTTAGGCTA
CCATAGGAAGGACCGCGCA -> CATAGGAAGGACCGCGCAC
GATACTCCTTCCCGGGGTC -> ATACTCCTTCCCGGGGTCC
ACTGCGGCATTAGAGACTT -> CTGCGGCATTAGAGACTTA
CGTCTCGGCACGCACATTA -> GTCTCGGCACGCACATTAA
ACTGGTGCACTAACTGTAA -> CTGGTGCACTAACTGTAAA
ACACTCTCGGGTTCTAAGC -> CACTCTCGGGTTCTAAGCT
CAGATACGGTTCATACCTT -> AGATACGGTTCATACCTTT
GGGCTCCACCACATGGTCA -> GGCTCCACCACATGGTCAT
TAACTGACGAGTTACGCTA -> AACTGACGAGTTACGCTAG
TAGATGCCGTTAATAGCGC -> AGATGCCGTTAATAGCGCA
GTATCCCTACGATAGAGGA -> TATCCCTACGATAGAGGAT
CAATGTCAAGGCGGTCTGC -> AATGTCAAGGCGGTCTGCT
TCTATATTGAAGTAGGGCT -> CTATATTGAAGTAGGGCTC
GTTATCAGATACTCCTTCC -> TTATCAGATACTCCTTCCC
TCAGGGCTTGTTAGTTGCT -> CAGGGCTTGTTAGTTGCTA
TATACGGTGGTGTCCTGGG -> ATACGGTGGTGTCCTGGGG
AAACCTGGTACCTAGTTGT -> AACCTGGTACCTAGTTGTC
CATTCGTACGGCACTAAGG -> ATTCGTACGGCACTAAGGA
CGGACTATTAACAGGACAG -> GGACTATTAACAGGACAGC
GGAATGAGGCATTCTATGC -> GAATGAGGCATTCTATGCC
GCCACTAGGCCTCTTGCTC -> CCACTAGGCCTCTTGCTCG
CACTGCCGGTGCTCCTTTT -> ACTGCCGGTGCTCCTTTTA
TAGCGTTGAGTTACAGCCA -> AGCGTTGAGTTACAGCCAA
GCGTTTGCCAATAAAATTA -> CGTTTGCCAATAAAATTAC
GCCCGCAAAGGAGACCCAT -> CCCGCAAAGGAGACCCATA
CATAAGACGGCGATGCGAA -> ATAAGACGGCGATGCGAAG
GCCGGTGCTCCTTTTAGCT -> CCGGTGCTCCTTTTAGCTA
TGTCCCTTCACTGCCGGTG -> GTCCCTTCACTGCCGGTGC
AGACGGCGATGCGAAGTTA -> GACGGCGATGCGAAGTTAT
CGGCGATGCGAAGTTATCA -> GGCGATGCGAAGTTATCAG
GACTATTAACAGGACAGCG -> ACTATTAACAGGACAGCGT
AATACGTTACGTTATACGG -> ATACGTTACGTTATACGGT
ATGGATCTCCATAAGAAAA -> TGGATCTCCATAAGAAAAG
TAGTTGTCCGCTTTTAGCC -> AGTTGTCCGCTTTTAGCCA
GCCTTTCCAAATGAGGTCC -> CCTTTCCAAATGAGGTCCG
ACGCTAGCTGCAACGACAC -> CGCTAGCTGCAACGACACC
ACCACATGGTCATCCAGGG -> CCACATGGTCATCCAGGGA
TCTTGCTCGTACTTGAGCG -> CTTGCTCGTACTTGAGCGC
CGGCACGCACATTAAGGAC -> GGCACGCACATTAAGGACG
TAGCTCAGGGCTTGTTAGT -> AGCTCAGGGCTTGTTAGTT
TGTCTCTGTCCCTTCACTG -> GTCTCTGTCCCTTCACTGC
ACCTTTACTCGGTTCACCC -> CCTTTACTCGGTTCACCCT
ATTAATCCCACGAGATCCT -> TTAATCCCACGAGATCCTG
AGCGTAGCAACTGCGGCAT -> GCGTAGCAACTGCGGCATT
TTACTTGTTTCGCCGATCG -> TACTTGTTTCGCCGATCGA
GCGATTTACTTCATGGATC -> CGATTTACTTCATGGATCT
GTTGGCTCAGATACGAGCG -> TTGGCTCAGATACGAGCGC
GGCGCAACAGACCAAGATT -> GCGCAACAGACCAAGATTT
TGCACTAACTGTAAAGACT -> GCACTAACTGTAAAGACTC
AGGCATTCTATGCCCGCAA -> GGCATTCTATGCCCGCAAA
CGGCAACTCTTGGGTTCAG -> GGCAACTCTTGGGTTCAGG
CTCGACAACCGACGCTAAT -> TCGACAACCGACGCTAATG
ATGGCCAATTACGTGGAGG -> TGGCCAATTACGTGGAGGC
TCTTTGAATAGCGTTGAGT -> CTTTGAATAGCGTTGAGTT
CCGCGATTTACTTCATGGA -> CGCGATTTACTTCATGGAT
TCTGACTTAGTATGTGGTA -> CTGACTTAGTATGTGGTAC
TGACGGTGCCCTACGTCGA -> GACGGTGCCCTACGTCGAT
CTCATCATCCGAATATTGC -> TCATCATCCGAATATTGCT
CTATATTGAAGTAGGGCTC -> TATATTGAAGTAGGGCTCC
AACATGAAAAGGGGACTTG -> ACATGAAAAGGGGACTTGA
ACCTCCAGACGGGGCTCCG -> CCTCCAGACGGGGCTCCGG
GCTCCACCACATGGTCATC -> CTCCACCACATGGTCATCC
TTCATTTGTTGGATTAAAA -> TCATTTGTTGGATTAAAAC
TCCGCTTTTAGCCACTAGG -> CCGCTTTTAGCCACTAGGC
TACTCGGTTCACCCTTCCG -> ACTCGGTTCACCCTTCCGA
CTTGTTAGTTGCTACACTC -> TTGTTAGTTGCTACACTCT
TTGTGAGTCTTTGAATAGC -> TGTGAGTCTTTGAATAGCG
CGGCGCAACAGACCAAGAT -> GGCGCAACAGACCAAGATT
ACAGAACATGAAAAGGGGA -> CAGAACATGAAAAGGGGAC
ACCCATAGCTTCATAAAAC -> CCCATAGCTTCATAAAACC
TGGGACTTGGGCCTTGACG -> GGGACTTGGGCCTTGACGC
TCACGCACCTGCACTGCAA -> CACGCACCTGCACTGCAAC
GTGCGGTGACTCTGCACTG -> TGCGGTGACTCTGCACTGC
GTGGTGTCCTGGGGTAGGC -> TGGTGTCCTGGGGTAGGCG
TGCCCGCAAAGGAGACCCA -> GCCCGCAAAGGAGACCCAT
AGGACCGCGCACAGAACAT -> GGACCGCGCACAGAACATG
CGCCCTCAATGTCAAGGCG -> GCCCTCAATGTCAAGGCGG
TTCTATAATACCATTGGAT -> TCTATAATACCATTGGATA
CAACCGACGCTAATGCTAT -> AACCGACGCTAATGCTATT
TCACCGTGCCGTATCATGG -> CACCGTGCCGTATCATGGG
TGCACGTCTCGGCACGCAC -> GCACGTCTCGGCACGCACA
ATACGGTGGTGTCCTGGGG -> TACGGTGGTGTCCTGGGGT
TGTCCGGCGCGGACTATTA -> GTCCGGCGCGGACTATTAA
TGCCAAGGAGACCCATAGC -> GCCAAGGAGACCCATAGCT
CCCTTCCGAGAGTTGTCTA -> CCTTCCGAGAGTTGTCTAT
CCCTCCCCCGTCTTTAGGA -> CCTCCCCCGTCTTTAGGAC
AGAAGGAGACTTCACCAGC -> GAAGGAGACTTCACCAGCC
CATAGCTTCATTGTGCGGT -> ATAGCTTCATTGTGCGGTG
AGGGAGGACCTACTCACTT -> GGGAGGACCTACTCACTTT
GGTGAGTTCACTATGCTAC -> GTGAGTTCACTATGCTACA
CCGTATCATGGGACCGGTA -> CGTATCATGGGACCGGTAT
CAGGTGCCAGCTAACTGAC -> AGGTGCCAGCTAACTGACG
CGTGCCGTATCATGGGACC -> GTGCCGTATCATGGGACCG
ACCTGGTACCTAGTTGTCC -> CCTGGTACCTAGTTGTCCG
GTCCGCGCTACTCGACAAC -> TCCGCGCTACTCGACAACC
GTTATACGGTGGTGTCCTG -> TTATACGGTGGTGTCCTGG
TGTATATAGGTTTGACGGT -> GTATATAGGTTTGACGGTA
CGTTTGCCAATAAAATTAC -> GTTTGCCAATAAAATTACT
ACATTAAGGACGGCGCAAC -> CATTAAGGACGGCGCAACA
AAGGAGCTTCGAACTGCTC -> AGGAGCTTCGAACTGCTCT
TACTTTCGTTACGGTCGTT -> ACTTTCGTTACGGTCGTTT
GGGAGTTCAGGATTTAGAG -> GGAGTTCAGGATTTAGAGC
GGACGTTGCCTTTCCAAAT -> GACGTTGCCTTTCCAAATG
TGAGTTACAGCCAATTGCT -> GAGTTACAGCCAATTGCTA
GTCCACAGGGAGGAGGGGA -> TCCACAGGGAGGAGGGGAG
TCTGCCGTGGGCGAGAGTT -> CTGCCGTGGGCGAGAGTTT
CCCTCATTGTGAGTCTTTG -> CCTCATTGTGAGTCTTTGA
AGACCCATAGCTTCATTTC -> GACCCATAGCTTCATTTCG
TGTGAGTCTTTGAATAGCG -> GTGAGTCTTTGAATAGCGT
GGATTTAGAGCGGTTCACC -> GATTTAGAGCGGTTCACCA
CCACTACCCCAAATATTCA -> CACTACCCCAAATATTCAG
TATGACGCCCTCAATGTCA -> ATGACGCCCTCAATGTCAA
TACAGCCAATTGCTAACGG -> ACAGCCAATTGCTAACGGG
TACGAGCGCCTGACGCCTC -> ACGAGCGCCTGACGCCTCG
AGTATGTGGTACTCCTTAC -> GTATGTGGTACTCCTTACA
AAAGAGTAGCTCATTTACT -> AAGAGTAGCTCATTTACTT
GGTCATCCAGGGAGGACCT -> GTCATCCAGGGAGGACCTA
GCCTTGACGCTGTCCGGGA -> CCTTGACGCTGTCCGGGAA
TTCGAAAAGAACGACTCAA -> TCGAAAAGAACGACTCAAG
GGTGACTCTGCACTGCCCT -> GTGACTCTGCACTGCCCTA
GTTACTTCAGGAATGAGGC -> TTACTTCAGGAATGAGGCA
CGTGGGCGAGAGTTTCTCC -> GTGGGCGAGAGTTTCTCCT
CAGGGAGGACCTACTCACT -> AGGGAGGACCTACTCACTT
AGCTCAGGGCTTGTTAGTT -> GCTCAGGGCTTGTTAGTTG
CTCCACAGGTGCCAGCTAA -> TCCACAGGTGCCAGCTAAC
AGGATTTAGAGCGGTTCAC -> GGATTTAGAGCGGTTCACC
CCACATGGTCATCCAGGGA -> CACATGGTCATCCAGGGAG
CCGCGTAGGTTTATGGATC -> CGCGTAGGTTTATGGATCT
GATTTTTCCCTCATTGTGA -> ATTTTTCCCTCATTGTGAG
GCCAGCTAACTGACGAGTT -> CCAGCTAACTGACGAGTTA
CAGGAATGAGGCATTCACG -> AGGAATGAGGCATTCACGA
TCCCTTCACTGCCGGTGCT -> CCCTTCACTGCCGGTGCTC
TGAGGCATTCCGCCTCTGC -> GAGGCATTCCGCCTCTGCC
ACTATTAACAGGACAGCGT -> CTATTAACAGGACAGCGTT
CGCTATGTTAGGCTATGAT -> GCTATGTTAGGCTATGATT
AACCATAGGAAGGACCGCG -> ACCATAGGAAGGACCGCGC
ACGTTATACGGTGGTGTCC -> CGTTATACGGTGGTGTCCT
CATCCGAATATTGCTATGA -> ATCCGAATATTGCTATGAC
ACTGCCCTAAACCTGGTAC -> CTGCCCTAAACCTGGTACC
ATTACGTGGAGGCTGTCGC -> TTACGTGGAGGCTGTCGCT
TCAGGGTACAGTTTCTATA -> CAGGGTACAGTTTCTATAA
TTACAGCGCAAGCCCGGCA -> TACAGCGCAAGCCCGGCAA
TTCATGGATCTCCATAAGA -> TCATGGATCTCCATAAGAA
GATCACGCACCTGCACTGC -> ATCACGCACCTGCACTGCA
GCTACTATGAGAGCAGTCT -> CTACTATGAGAGCAGTCTT
TGCCCTACGTCGATGATGT -> GCCCTACGTCGATGATGTA
CCCAAATATTCAGGAATGA -> CCAAATATTCAGGAATGAG
ACTTTCGTTACGGTCGTTT -> CTTTCGTTACGGTCGTTTC
GACGGGGCTCCGGAACGCG -> ACGGGGCTCCGGAACGCGG
GGTGCTCCTTTTAGCTACA -> GTGCTCCTTTTAGCTACAA
TGCCGTATCATGGGACCGG -> GCCGTATCATGGGACCGGT
TTTAGGACACCCGCACCAA -> TTAGGACACCCGCACCAAC
GATCGCGGCGGACAAGTAT -> ATCGCGGCGGACAAGTATC
CCAGCCTGTCTCTGTCCCT -> CAGCCTGTCTCTGTCCCTT
AGTTCCTGGAACAAGGGGA -> GTTCCTGGAACAAGGGGAT
TATTAAGGAGACCCATAGC -> ATTAAGGAGACCCATAGCT
CCAAGGAGACCCATAGCTT -> CAAGGAGACCCATAGCTTC
CTCAAGACTTGCTACTATG -> TCAAGACTTGCTACTATGA
AGGAGGGGAGTTCAGGATT -> GGAGGGGAGTTCAGGATTT
GACTTCACCAGCCTGTCTC -> ACTTCACCAGCCTGTCTCT
ACCCCGCGATTTACTTCAT -> CCCCGCGATTTACTTCATG
CTTCATGGATCTCCATAAG -> TTCATGGATCTCCATAAGA
GACAAGTATCCATCGGCTG -> ACAAGTATCCATCGGCTGC
CCCGGGGTCCCGGTGGTGA -> CCGGGGTCCCGGTGGTGAG
ACCCGCACCAACCATAGGA -> CCCGCACCAACCATAGGAA
TCCCTCATTGTGAGTCTTT -> CCCTCATTGTGAGTCTTTG
CCGGCGCGGACTATTAACA -> CGGCGCGGACTATTAACAG
AAAAGTGATAGAGTAGAGT -> AAAGTGATAGAGTAGAGTA
TCCATCGGCTGCTATTTGT -> CCATCGGCTGCTATTTGTG
TTGACGCTGTCCGGGAAAC -> TGACGCTGTCCGGGAAACT
ATTACTCTGACTTAGTATG -> TTACTCTGACTTAGTATGT
TTGTGCGGTGACTCTGCAC -> TGTGCGGTGACTCTGCACT
CGTGTGTTGTCCGGCGCGG -> GTGTGTTGTCCGGCGCGGA
TGGTGTCCTGGGGTAGGCG -> GGTGTCCTGGGGTAGGCGT
TGTGGTACTCCTTACAGCG -> GTGGTACTCCTTACAGCGC
TATTTTGGCAGGAACCCAG -> ATTTTGGCAGGAACCCAGA
GCTAATGCTATTTGTATAT -> CTAATGCTATTTGTATATA
CCCAGATACGGTTCATACC -> CCAGATACGGTTCATACCT
CCGCGCACAGAACATGAAA -> CGCGCACAGAACATGAAAA
GTTGCTACACTCTCGGGTT -> TTGCTACACTCTCGGGTTC
CATGGGACCGGTATCCCTA -> ATGGGACCGGTATCCCTAC
TAGAGTAGAGTAAAAGAGT -> AGAGTAGAGTAAAAGAGTA
GGCCGAGGACTCCACAGGT -> GCCGAGGACTCCACAGGTG
CACCCGTAGTCGCGGGACT -> ACCCGTAGTCGCGGGACTG
TCACCATCGCGGCAACTCT -> CACCATCGCGGCAACTCTT
CGGGAAACTGACTGGATAA -> GGGAAACTGACTGGATAAG
ACCCATAGCTTCATTGTGC -> CCCATAGCTTCATTGTGCG
TTAGCCACTAGGCCTCTTG -> TAGCCACTAGGCCTCTTGC
CTGACGAGTTACGCTAGTA -> TGACGAGTTACGCTAGTAA
GGATTAAAACCGTGCACCA -> GATTAAAACCGTGCACCAG
GAACCACTACCCCAAATAT -> AACCACTACCCCAAATATT
ATTGAGCGTTTGCCAATAA -> TTGAGCGTTTGCCAATAAA
CATTAATCCCACGAGATCC -> ATTAATCCCACGAGATCCT
GCTAACTGACGAGTTACGC -> CTAACTGACGAGTTACGCT
CTCCGCTGAGGAACCACTA -> TCCGCTGAGGAACCACTAC
CAAGACTTGCTACTATGAG -> AAGACTTGCTACTATGAGA
ACTCAAGCGTATTTTTCAT -> CTCAAGCGTATTTTTCATT
GAGTAACATGGGGAACATG -> AGTAACATGGGGAACATGC
CTAGGCCTCTTGCTCGTAC -> TAGGCCTCTTGCTCGTACT
GTTCACTATGCTACATAAG -> TTCACTATGCTACATAAGC
AGAGACTTAGAAGACGCTA -> GAGACTTAGAAGACGCTAG
TTCGCCGACGAGGCTGCGT -> TCGCCGACGAGGCTGCGTT
GACGAGTGTTAGACGACCA -> ACGAGTGTTAGACGACCAT
GCGTATTTTTCATTTGTTG -> CGTATTTTTCATTTGTTGG
CAACCGGCGTCATCGTAGT -> AACCGGCGTCATCGTAGTC
TTAACAGGACAGCGTTGGC -> TAACAGGACAGCGTTGGCT
TCGTAGTCGCCAAATATGG -> CGTAGTCGCCAAATATGGT
ATAGCGCAGTCCACAGGGA -> TAGCGCAGTCCACAGGGAG
TAGGTTTGACGGTAGCTCA -> AGGTTTGACGGTAGCTCAG
TAAGCTTCGCCGACGAGGC -> AAGCTTCGCCGACGAGGCT
GTGATAGAGTAGAGTAAAA -> TGATAGAGTAGAGTAAAAG
GCTGATGTATTATTAGGTA -> CTGATGTATTATTAGGTAT
GCCCGGCAATTCAAGTGAA -> CCCGGCAATTCAAGTGAAG
ACGAGCGCCTGACGCCTCG -> CGAGCGCCTGACGCCTCGC
AACGGGACCCCGTCCTTAT -> ACGGGACCCCGTCCTTATT
CACTTTTCCCCGTGTGTTG -> ACTTTTCCCCGTGTGTTGT
AATGAGGCATTCACGAGTT -> ATGAGGCATTCACGAGTTA
TCGCGGCGGACAAGTATCC -> CGCGGCGGACAAGTATCCA
TTCCGAGAGTTGTCTATAT -> TCCGAGAGTTGTCTATATT
ACAAGTATCCATCGGCTGC -> CAAGTATCCATCGGCTGCT
AGCCCGGCAATTCAAGTGA -> GCCCGGCAATTCAAGTGAA
AATAGCGCAGTCCACAGGG -> ATAGCGCAGTCCACAGGGA
GGAGACCCATAGCTTCATA -> GAGACCCATAGCTTCATAA, GAGACCCATAGCTTCATAA
GTGTTGTCCGGCGCGGACT -> TGTTGTCCGGCGCGGACTA
ATGCTATTTGTATATAGGT -> TGCTATTTGTATATAGGTT
CTAGCTGCAACGACACCCG -> TAGCTGCAACGACACCCGT
ACTCTCGGGTTCTAAGCTT -> CTCTCGGGTTCTAAGCTTA
GTTTGCCAATAAAATTACT -> TTTGCCAATAAAATTACTC
TGAGTTCACTATGCTACAT -> GAGTTCACTATGCTACATA
ACGCACCTGCACTGCAACC -> CGCACCTGCACTGCAACCG
AGGTGCCAGCTAACTGACG -> GGTGCCAGCTAACTGACGA
GGTTTATGGATCTCAAGAC -> GTTTATGGATCTCAAGACT
CCCCGACGAGTGTTAGACG -> CCCGACGAGTGTTAGACGA
ATTCAAGTGAAGGCGAAGA -> TTCAAGTGAAGGCGAAGAA
GGTGGTGTCCTGGGGTAGG -> GTGGTGTCCTGGGGTAGGC
ACCATAGGAAGGACCGCGC -> CCATAGGAAGGACCGCGCA
AGGCGGTCTGCTGATGTAT -> GGCGGTCTGCTGATGTATT
TGCCGTTAATAGCGCAGTC -> GCCGTTAATAGCGCAGTCC
GATAAGATCACGCACCTGC -> ATAAGATCACGCACCTGCA
AGACTCGGTCTGGACGTTG -> GACTCGGTCTGGACGTTGC
CGGCATTAGAGACTTAGAA -> GGCATTAGAGACTTAGAAG
GGCTGTCGCTCACCGTGCC -> GCTGTCGCTCACCGTGCCG
CTTACTTGTTTCGCCGATC -> TTACTTGTTTCGCCGATCG
TAGGCGTCTTGACTCTCAT -> AGGCGTCTTGACTCTCATC
TGTTAGTTGCTACACTCTC -> GTTAGTTGCTACACTCTCG
ATAGGTTTGACGGTAGCTC -> TAGGTTTGACGGTAGCTCA
CCGGTGCTCCTTTTAGCTA -> CGGTGCTCCTTTTAGCTAC
TGCTGTCCGCGCTACTCGA -> GCTGTCCGCGCTACTCGAC
ACATGGGGAACATGCTTGC -> CATGGGGAACATGCTTGCT
CATAGCTTCATAAGACGGC -> ATAGCTTCATAAGACGGCG
AGGGAGGAGGGGAGTTCAG -> GGGAGGAGGGGAGTTCAGG
TAGTATGTGGTACTCCTTA -> AGTATGTGGTACTCCTTAC
GCGTTGAGTTACAGCCAAT -> CGTTGAGTTACAGCCAATT
CCTTTCCAAATGAGGTCCG -> CTTTCCAAATGAGGTCCGC
AAGGAGACCCATAGCTTCA -> AGGAGACCCATAGCTTCAT, AGGAGACCCATAGCTTCAT, AGGAGACCCATAGCTTCAT, AGGAGACCCATAGCTTCAT
AGATACGAGCGCCTGACGC -> GATACGAGCGCCTGACGCC
TGAGTCTTTGAATAGCGTT -> GAGTCTTTGAATAGCGTTG
AGACCAAACTGTGGGACTT -> GACCAAACTGTGGGACTTG
GAGGCATTCACGAGTTATT -> AGGCATTCACGAGTTATTA
TCGCCGATCGATGGCCAAT -> CGCCGATCGATGGCCAATT
TTAGAGCGGTTCACCATCG -> TAGAGCGGTTCACCATCGC
TTTACTCGGTTCACCCTTC -> TTACTCGGTTCACCCTTCC
GACCCATAGCTTCATTGTG -> ACCCATAGCTTCATTGTGC
GGATCTCCATAAGAAAAGT -> GATCTCCATAAGAAAAGTG
TTGGGCCTTGACGCTGTCC -> TGGGCCTTGACGCTGTCCG
ATAAGACGGCGATGCGAAG -> TAAGACGGCGATGCGAAGT
GGTATAGATGCCGTTAATA -> GTATAGATGCCGTTAATAG
GACGCTGTCCGGGAAACTG -> ACGCTGTCCGGGAAACTGA
CTGACGCCTCGCGGAGCCC -> TGACGCCTCGCGGAGCCCC
CTGGTGCACTAACTGTAAA -> TGGTGCACTAACTGTAAAG
ATACGAGCGCCTGACGCCT -> TACGAGCGCCTGACGCCTC
GAGTTACGCTAGTAAGGAG -> AGTTACGCTAGTAAGGAGC
CTACTCACTTTTCCCCGTG -> TACTCACTTTTCCCCGTGT
AGTTATCAGATACTCCTTC -> GTTATCAGATACTCCTTCC
AGGACTCCACAGGTGCCAG -> GGACTCCACAGGTGCCAGC
CGTTACGTTATACGGTGGT -> GTTACGTTATACGGTGGTG
AGGCATTCACGAGTTATTA -> GGCATTCACGAGTTATTAA
TACCTTTACTCGGTTCACC -> ACCTTTACTCGGTTCACCC
GGTGAGAAATACGTTACGT -> GTGAGAAATACGTTACGTT
CGCTAGCTGCAACGACACC -> GCTAGCTGCAACGACACCC
GTTCTAAGCTTAGCGTAGC -> TTCTAAGCTTAGCGTAGCA
TGACGCTGTCCGGGAAACT -> GACGCTGTCCGGGAAACTG
CGGACAAGTATCCATCGGC -> GGACAAGTATCCATCGGCT
CGGGGTCCCGGTGGTGAGA -> GGGGTCCCGGTGGTGAGAA
CGCGGCAACTCTTGGGTTC -> GCGGCAACTCTTGGGTTCA
TTCTGCCGTGGGCGAGAGT -> TCTGCCGTGGGCGAGAGTT
CCTGTCTCTGTCCCTTCAC -> CTGTCTCTGTCCCTTCACT
TGGCTCAGATACGAGCGCC -> GGCTCAGATACGAGCGCCT
AAAGAACGACTCAAGCGTA -> AAGAACGACTCAAGCGTAT
ATGATGTAAGCCGTCGTTC -> TGATGTAAGCCGTCGTTCT
TTCGTTACGGTCGTTTCCG -> TCGTTACGGTCGTTTCCGG
GTTAGCTAGTTGCCCACAT -> TTAGCTAGTTGCCCACATT
GTAGGTTTATGGATCTCAA -> TAGGTTTATGGATCTCAAG
AGTGATAGAGTAGAGTAAA -> GTGATAGAGTAGAGTAAAA
GAGAGTTGTCTATATTGAA -> AGAGTTGTCTATATTGAAG
GAATATTGCTATGACGCCC -> AATATTGCTATGACGCCCT
CCCGTGTGTTGTCCGGCGC -> CCGTGTGTTGTCCGGCGCG
CTGTTAGCGTTAGCTAGTT -> TGTTAGCGTTAGCTAGTTG
CCGCGCTACTCGACAACCG -> CGCGCTACTCGACAACCGA
CTCGGCACGCACATTAAGG -> TCGGCACGCACATTAAGGA
GAGTTTCTCCTGTTAGCGT -> AGTTTCTCCTGTTAGCGTT
CACTGCCCTAAACCTGGTA -> ACTGCCCTAAACCTGGTAC
GACGCTAGCTGCAACGACA -> ACGCTAGCTGCAACGACAC
TATATAGGTTTGACGGTAG -> ATATAGGTTTGACGGTAGC
GGGGCTCCGGAACGCGGTG -> GGGCTCCGGAACGCGGTGA
CTATGTTAGGCTATGATTG -> TATGTTAGGCTATGATTGA
TGGGCCTTGACGCTGTCCG -> GGGCCTTGACGCTGTCCGG
CGTTAGCTAGTTGCCCACA -> GTTAGCTAGTTGCCCACAT
AGTTCACTATGCTACATAA -> GTTCACTATGCTACATAAG
CTCCACCACATGGTCATCC -> TCCACCACATGGTCATCCA
TTGTATGTCATTGACCTCC -> TGTATGTCATTGACCTCCG
GGTTCTAAGCTTAGCGTAG -> GTTCTAAGCTTAGCGTAGC
CAGACCAAGATTTTTCCCT -> AGACCAAGATTTTTCCCTC
ACCAGCCTGTCTCTGTCCC -> CCAGCCTGTCTCTGTCCCT
AAACCGTGCACCAGACGAC -> AACCGTGCACCAGACGACG
GCCCACATTGCACGTCTCG -> CCCACATTGCACGTCTCGG
CGGTGGTGTCCTGGGGTAG -> GGTGGTGTCCTGGGGTAGG
CTGGATTAAGAGTCTGATT -> TGGATTAAGAGTCTGATTT
GAGGAGGGGAGTTCAGGAT -> AGGAGGGGAGTTCAGGATT
GAGCCCACTCCGCTGAGGA -> AGCCCACTCCGCTGAGGAA
CCCGCTTGCCCTCCCTCAT -> CCGCTTGCCCTCCCTCATC
ACCCATAGCTTCATTTCGA -> CCCATAGCTTCATTTCGAA
TCCGAGAGTTGTCTATATT -> CCGAGAGTTGTCTATATTG
CTCTTGGGTTCAGGAATGA -> TCTTGGGTTCAGGAATGAG
GCCCTACGTCGATGATGTA -> CCCTACGTCGATGATGTAA
TTCCCTCATTGTGAGTCTT -> TCCCTCATTGTGAGTCTTT
ATGAAAAGGGGACTTGACC -> TGAAAAGGGGACTTGACCG
TCACGAGTTATTAAGGAGA -> CACGAGTTATTAAGGAGAC
TTAAGGAGACCCATAGCTT -> TAAGGAGACCCATAGCTTC
GATGTATTATTAGGTATTT -> ATGTATTATTAGGTATTTC
TTGGGTTCAGGAATGAGGC -> TGGGTTCAGGAATGAGGCA
CCCATAGCTTCATAAGACG -> CCATAGCTTCATAAGACGG
CGCGCACAGAACATGAAAA -> GCGCACAGAACATGAAAAG
ACTAAGGAGACCCATAGCT -> CTAAGGAGACCCATAGCTT
AGAAATACGTTACGTTATA -> GAAATACGTTACGTTATAC
TCCGTTCAGACCGAGTAAC -> CCGTTCAGACCGAGTAACA
TTTCTCCTGTTAGCGTTAG -> TTCTCCTGTTAGCGTTAGC
GGACCCCGTCCTTATTTTG -> GACCCCGTCCTTATTTTGG
AGGAGACCCATAGCTTCAT -> GGAGACCCATAGCTTCATT, GGAGACCCATAGCTTCATT, GGAGACCCATAGCTTCATA, GGAGACCCATAGCTTCATA
TTCCGGTCGAGACCAAACT -> TCCGGTCGAGACCAAACTG
AAGTATCCATCGGCTGCTA -> AGTATCCATCGGCTGCTAT
GCTCAGGGCTTGTTAGTTG -> CTCAGGGCTTGTTAGTTGC
TTTCCCTCATTGTGAGTCT -> TTCCCTCATTGTGAGTCTT
GTCGTTTCCGGTCGAGACC -> TCGTTTCCGGTCGAGACCA
CTAACTGACGAGTTACGCT -> TAACTGACGAGTTACGCTA
CGTACGGCACTAAGGAGAC -> GTACGGCACTAAGGAGACC
GCACGTCTCGGCACGCACA -> CACGTCTCGGCACGCACAT
TAGCTCATTTACTTTCGTT -> AGCTCATTTACTTTCGTTA
GCATTCACGAGTTATTAAG -> CATTCACGAGTTATTAAGG
TAACAGGACAGCGTTGGCT -> AACAGGACAGCGTTGGCTC
CTCTGCCAAGGAGACCCAT -> TCTGCCAAGGAGACCCATA
TTCTATGCCCGCAAAGGAG -> TCTATGCCCGCAAAGGAGA
AATACCATTGGATACTTAG -> ATACCATTGGATACTTAGT
GTGCACTAACTGTAAAGAC -> TGCACTAACTGTAAAGACT
GGGGAACATGCTTGCTGTC -> GGGAACATGCTTGCTGTCC
AGGTATTTCAGGAATGAGG -> GGTATTTCAGGAATGAGGC
AACTGCGGCATTAGAGACT -> ACTGCGGCATTAGAGACTT
CCATTAATCCCACGAGATC -> CATTAATCCCACGAGATCC
ACAGGACAGCGTTGGCTCA -> CAGGACAGCGTTGGCTCAG
CTGTCCGCGCTACTCGACA -> TGTCCGCGCTACTCGACAA
TACTTAGTTCCTGGAACAA -> ACTTAGTTCCTGGAACAAG
CGGTAGCTCAGGGCTTGTT -> GGTAGCTCAGGGCTTGTTA
ATGAGGCATTCGTACGGCA -> TGAGGCATTCGTACGGCAC
CCCTCCCTCATCATCCGAA -> CCTCCCTCATCATCCGAAT
CATGGATCTCCATAAGAAA -> ATGGATCTCCATAAGAAAA
GGCGCGGACTATTAACAGG -> GCGCGGACTATTAACAGGA
GTAAGGAGCTTCGAACTGC -> TAAGGAGCTTCGAACTGCT
TGTTAGCGTTAGCTAGTTG -> GTTAGCGTTAGCTAGTTGC
AGTCTTTGAATAGCGTTGA -> GTCTTTGAATAGCGTTGAG
ACTTAGAAGACGCTAGCTG -> CTTAGAAGACGCTAGCTGC
GTCTGATTTAGATGACGGT -> TCTGATTTAGATGACGGTG
CACCCGCACCAACCATAGG -> ACCCGCACCAACCATAGGA
GGTGCCCTACGTCGATGAT -> GTGCCCTACGTCGATGATG
GGGGACTTGACCGACTGGT -> GGGACTTGACCGACTGGTG
ATTGTGCGGTGACTCTGCA -> TTGTGCGGTGACTCTGCAC
GACCAAACTGTGGGACTTG -> ACCAAACTGTGGGACTTGG
AGCCCACTCCGCTGAGGAA -> GCCCACTCCGCTGAGGAAC
TATGTTAGGCTATGATTGA -> ATGTTAGGCTATGATTGAG
TCTTGACTCTCATCAGGGT -> CTTGACTCTCATCAGGGTA
GCGCAAGCCCGGCAATTCA -> CGCAAGCCCGGCAATTCAA
ACCCCAAATATTCAGGAAT -> CCCCAAATATTCAGGAATG
TAGGACACCCGCACCAACC -> AGGACACCCGCACCAACCA
GTTTATGGATCTCAAGACT -> TTTATGGATCTCAAGACTT
CGCTACTCGACAACCGACG -> GCTACTCGACAACCGACGC
ACTATGCTACATAAGCTTC -> CTATGCTACATAAGCTTCG
AGCCAATTGCTAACGGGAC -> GCCAATTGCTAACGGGACC
CACTACCCCAAATATTCAG -> ACTACCCCAAATATTCAGG
GAAAAGAACGACTCAAGCG -> AAAAGAACGACTCAAGCGT
TAGTTGCTACACTCTCGGG -> AGTTGCTACACTCTCGGGT
TCAAGACTTGCTACTATGA -> CAAGACTTGCTACTATGAG
TGAGGCATTCACGAGTTAT -> GAGGCATTCACGAGTTATT
GGACTATTAACAGGACAGC -> GACTATTAACAGGACAGCG
GAATGAGGCATTCCGCCTC -> AATGAGGCATTCCGCCTCT
ACCATCGCGGCAACTCTTG -> CCATCGCGGCAACTCTTGG
ACTCTTGGGTTCAGGAATG -> CTCTTGGGTTCAGGAATGA
TGCTCGTACTTGAGCGCGT -> GCTCGTACTTGAGCGCGTC
GCGTCCAACGGACCCCGCG -> CGTCCAACGGACCCCGCGA
GCATTCGTACGGCACTAAG -> CATTCGTACGGCACTAAGG
ACTCCGCTGAGGAACCACT -> CTCCGCTGAGGAACCACTA
TGAGGAACCACTACCCCAA -> GAGGAACCACTACCCCAAA
ATAATACCATTGGATACTT -> TAATACCATTGGATACTTA
CTAGTTGTCCGCTTTTAGC -> TAGTTGTCCGCTTTTAGCC
AAGCCCGGCAATTCAAGTG -> AGCCCGGCAATTCAAGTGA
CTCGTACTTGAGCGCGTCC -> TCGTACTTGAGCGCGTCCA
CCAACCATAGGAAGGACCG -> CAACCATAGGAAGGACCGC
ACGCACATTAAGGACGGCG -> CGCACATTAAGGACGGCGC
CTATGACGCCCTCAATGTC -> TATGACGCCCTCAATGTCA
GTGACTCTGCACTGCCCTA -> TGACTCTGCACTGCCCTAA
ACGCGGTGAGTTCACTATG -> CGCGGTGAGTTCACTATGC
GGTGTCCTGGGGTAGGCGT -> GTGTCCTGGGGTAGGCGTC
GAGCGGTTCACCATCGCGG -> AGCGGTTCACCATCGCGGC
GAGACCCATAGCTTCATTT -> AGACCCATAGCTTCATTTC
CTCATTGTGAGTCTTTGAA -> TCATTGTGAGTCTTTGAAT
TCTCAAGACTTGCTACTAT -> CTCAAGACTTGCTACTATG
TCCCGGGGTCCCGGTGGTG -> CCCGGGGTCCCGGTGGTGA
TTGACCTCCGTTCAGACCG -> TGACCTCCGTTCAGACCGA
GTAGCTCATTTACTTTCGT -> TAGCTCATTTACTTTCGTT
ACGACTCAAGCGTATTTTT -> CGACTCAAGCGTATTTTTC
GGTTCACCCTTCCGAGAGT -> GTTCACCCTTCCGAGAGTT
TGCCAGCTAACTGACGAGT -> GCCAGCTAACTGACGAGTT
CGCCAAATATGGTATAGAT -> GCCAAATATGGTATAGATG
TTAAAACCGTGCACCAGAC -> TAAAACCGTGCACCAGACG
GACGAGGCTGCGTTGTATG -> ACGAGGCTGCGTTGTATGT
TGCTTGCTGTCCGCGCTAC -> GCTTGCTGTCCGCGCTACT
TATCATGGGACCGGTATCC -> ATCATGGGACCGGTATCCC
CGCTAGTAAGGAGCTTCGA -> GCTAGTAAGGAGCTTCGAA
CAATTGCTAACGGGACCCC -> AATTGCTAACGGGACCCCG
ATGTGGTACTCCTTACAGC -> TGTGGTACTCCTTACAGCG
GCAATTCAAGTGAAGGCGA -> CAATTCAAGTGAAGGCGAA
GAGCGCCTGACGCCTCGCG -> AGCGCCTGACGCCTCGCGG
AGGTTTGACGGTAGCTCAG -> GGTTTGACGGTAGCTCAGG
ATTAGAGACTTAGAAGACG -> TTAGAGACTTAGAAGACGC
CGTGGAGGCTGTCGCTCAC -> GTGGAGGCTGTCGCTCACC
GGTTCACCATCGCGGCAAC -> GTTCACCATCGCGGCAACT
AAGATTTTTCCCTCATTGT -> AGATTTTTCCCTCATTGTG
ACCGGTATCCCTACGATAG -> CCGGTATCCCTACGATAGA
CCTCCCCCGTCTTTAGGAC -> CTCCCCCGTCTTTAGGACA
CTATTTGTATATAGGTTTG -> TATTTGTATATAGGTTTGA
CGACGAGGCTGCGTTGTAT -> GACGAGGCTGCGTTGTATG
CCGCTTGCCCTCCCTCATC -> CGCTTGCCCTCCCTCATCA
ATTCGTACGGCACTAAGGA -> TTCGTACGGCACTAAGGAG
GGCATTCGTACGGCACTAA -> GCATTCGTACGGCACTAAG
CTTGACCGACTGGTGCACT -> TTGACCGACTGGTGCACTA
GTCAAGGCGGTCTGCTGAT -> TCAAGGCGGTCTGCTGATG
TTACAGCCCTCCCCCGTCT -> TACAGCCCTCCCCCGTCTT
TTTTTCATTTGTTGGATTA -> TTTTCATTTGTTGGATTAA
TGGGTTCAGGAATGAGGCA -> GGGTTCAGGAATGAGGCAT
GTCTATATTGAAGTAGGGC -> TCTATATTGAAGTAGGGCT
GAAACTGACTGGATAAGAT -> AAACTGACTGGATAAGATC
AGTCTGATTTAGATGACGG -> GTCTGATTTAGATGACGGT
GGTATCCCTACGATAGAGG -> GTATCCCTACGATAGAGGA
TCACTATGCTACATAAGCT -> CACTATGCTACATAAGCTT
TGCGGTGACTCTGCACTGC -> GCGGTGACTCTGCACTGCC
GAAAAGTGATAGAGTAGAG -> AAAAGTGATAGAGTAGAGT
ATGGATCTCAAGACTTGCT -> TGGATCTCAAGACTTGCTA
GCGCCTGACGCCTCGCGGA -> CGCCTGACGCCTCGCGGAG
CTGATTTAGATGACGGTGC -> TGATTTAGATGACGGTGCC
AAATTACTCTGACTTAGTA -> AATTACTCTGACTTAGTAT
CGCGGCGGACAAGTATCCA -> GCGGCGGACAAGTATCCAT
AAGCTTCGCCGACGAGGCT -> AGCTTCGCCGACGAGGCTG
CTTCCGAGAGTTGTCTATA -> TTCCGAGAGTTGTCTATAT
CGCTCACCGTGCCGTATCA -> GCTCACCGTGCCGTATCAT
ACGGGGCTCCGGAACGCGG -> CGGGGCTCCGGAACGCGGT
GAGGCATTCTATGCCCGCA -> AGGCATTCTATGCCCGCAA
CCCGGCAATTCAAGTGAAG -> CCGGCAATTCAAGTGAAGG
GAGGTCCGCGTAGGTTTAT -> AGGTCCGCGTAGGTTTATG
ATGGGGAACATGCTTGCTG -> TGGGGAACATGCTTGCTGT
ATGTATTATTAGGTATTTC -> TGTATTATTAGGTATTTCA
AAGACGGCGATGCGAAGTT -> AGACGGCGATGCGAAGTTA
GGACAGCGTTGGCTCAGAT -> GACAGCGTTGGCTCAGATA
CCAGGGAGGACCTACTCAC -> CAGGGAGGACCTACTCACT
CAACTCTTGGGTTCAGGAA -> AACTCTTGGGTTCAGGAAT
CGCACAGAACATGAAAAGG -> GCACAGAACATGAAAAGGG
CCCCCGTCTTTAGGACACC -> CCCCGTCTTTAGGACACCC
CTGCGGCATTAGAGACTTA -> TGCGGCATTAGAGACTTAG
ATATTGAAGTAGGGCTCCA -> TATTGAAGTAGGGCTCCAC
TTCATAAGACGGCGATGCG -> TCATAAGACGGCGATGCGA
CGGTGACTCTGCACTGCCC -> GGTGACTCTGCACTGCCCT
CCGGGGTCCCGGTGGTGAG -> CGGGGTCCCGGTGGTGAGA
TGCTAACGGGACCCCGTCC -> GCTAACGGGACCCCGTCCT
CGCGATTTACTTCATGGAT -> GCGATTTACTTCATGGATC
TTATACGGTGGTGTCCTGG -> TATACGGTGGTGTCCTGGG
ACTGACTGGATAAGATCAC -> CTGACTGGATAAGATCACG
CCCTACGTCGATGATGTAA -> CCTACGTCGATGATGTAAG
GCGTAGGTTTATGGATCTC -> CGTAGGTTTATGGATCTCA
CCCGGTGGTGAGAAATACG -> CCGGTGGTGAGAAATACGT
ATGAGGTCCGCGTAGGTTT -> TGAGGTCCGCGTAGGTTTA
AAGAGTAGCTCATTTACTT -> AGAGTAGCTCATTTACTTT
GAGCAGTCTTACTTGTTTC -> AGCAGTCTTACTTGTTTCG
ACGCTGTCCGGGAAACTGA -> CGCTGTCCGGGAAACTGAC
ACAGCCAATTGCTAACGGG -> CAGCCAATTGCTAACGGGA
TAGCTGCAACGACACCCGT -> AGCTGCAACGACACCCGTA
GAGTAGCTCATTTACTTTC -> AGTAGCTCATTTACTTTCG
TCAGGAATGAGGCATTCGT -> CAGGAATGAGGCATTCGTA
AAATACGTTACGTTATACG -> AATACGTTACGTTATACGG
AGTAAAAGAGTAGCTCATT -> GTAAAAGAGTAGCTCATTT
TTGGATTAAAACCGTGCAC -> TGGATTAAAACCGTGCACC
TCTGATTTAGATGACGGTG -> CTGATTTAGATGACGGTGC
AAAAGAACGACTCAAGCGT -> AAAGAACGACTCAAGCGTA
TCCTGGGGTAGGCGTCTTG -> CCTGGGGTAGGCGTCTTGA
AATTCAAGTGAAGGCGAAG -> ATTCAAGTGAAGGCGAAGA
GCTTCGAACTGCTCTGTTA -> CTTCGAACTGCTCTGTTAC
TGCGAAGTTATCAGATACT -> GCGAAGTTATCAGATACTC
GGAGTTCAGGATTTAGAGC -> GAGTTCAGGATTTAGAGCG
GAGTTACAGCCAATTGCTA -> AGTTACAGCCAATTGCTAA
AGTAGAGTAAAAGAGTAGC -> GTAGAGTAAAAGAGTAGCT
GAGTAGAGTAAAAGAGTAG -> AGTAGAGTAAAAGAGTAGC
CCGCTGAGGAACCACTACC -> CGCTGAGGAACCACTACCC
ATTAAGAGTCTGATTTAGA -> TTAAGAGTCTGATTTAGAT
CAGCTAACTGACGAGTTAC -> AGCTAACTGACGAGTTACG
CAGGGTACAGTTTCTATAA -> AGGGTACAGTTTCTATAAT
GGCTGCTATTTGTGCCCGC -> GCTGCTATTTGTGCCCGCT
TCTCGGCACGCACATTAAG -> CTCGGCACGCACATTAAGG
CTGTCGCTCACCGTGCCGT -> TGTCGCTCACCGTGCCGTA
GACTCAAGCGTATTTTTCA -> ACTCAAGCGTATTTTTCAT
TTTGTATATAGGTTTGACG -> TTGTATATAGGTTTGACGG
GCCGTTAATAGCGCAGTCC -> CCGTTAATAGCGCAGTCCA
TGACCTCCGTTCAGACCGA -> GACCTCCGTTCAGACCGAG
ACATAAGCTTCGCCGACGA -> CATAAGCTTCGCCGACGAG
ACGACACCCGTAGTCGCGG -> CGACACCCGTAGTCGCGGG
AGACGACCATTAATCCCAC -> GACGACCATTAATCCCACG
TTGTCCGGCGCGGACTATT -> TGTCCGGCGCGGACTATTA
AACTGTGGGACTTGGGCCT -> ACTGTGGGACTTGGGCCTT
AAGTGATAGAGTAGAGTAA -> AGTGATAGAGTAGAGTAAA
TAAGGAGACCCATAGCTTC -> AAGGAGACCCATAGCTTCA, AAGGAGACCCATAGCTTCA
ACTTGAGCGCGTCCAACGG -> CTTGAGCGCGTCCAACGGA
TGTATTATTAGGTATTTCA -> GTATTATTAGGTATTTCAG
CTGACTTAGTATGTGGTAC -> TGACTTAGTATGTGGTACT
TATTTTTCATTTGTTGGAT -> ATTTTTCATTTGTTGGATT
CCAGACGGGGCTCCGGAAC -> CAGACGGGGCTCCGGAACG
GCGTCATCGTAGTCGCCAA -> CGTCATCGTAGTCGCCAAA
CTAGTAAGGAGCTTCGAAC -> TAGTAAGGAGCTTCGAACT
TTCATTGTGCGGTGACTCT -> TCATTGTGCGGTGACTCTG
GTACTCCTTACAGCGCAAG -> TACTCCTTACAGCGCAAGC
TCAATGTCAAGGCGGTCTG -> CAATGTCAAGGCGGTCTGC
GATAGAGTAGAGTAAAAGA -> ATAGAGTAGAGTAAAAGAG
GTTTCTCCTGTTAGCGTTA -> TTTCTCCTGTTAGCGTTAG
GCCAATTACGTGGAGGCTG -> CCAATTACGTGGAGGCTGT
GCTACACTCTCGGGTTCTA -> CTACACTCTCGGGTTCTAA
TTAATCCCACGAGATCCTG -> TAATCCCACGAGATCCTGA
TCGATGGCCAATTACGTGG -> CGATGGCCAATTACGTGGA
ATGCCCGCAAAGGAGACCC -> TGCCCGCAAAGGAGACCCA
CAAGGCGGTCTGCTGATGT -> AAGGCGGTCTGCTGATGTA
CAGCCTGTCTCTGTCCCTT -> AGCCTGTCTCTGTCCCTTC
TTTCGCCGATCGATGGCCA -> TTCGCCGATCGATGGCCAA
CCTGCACTGCAACCGGCGT -> CTGCACTGCAACCGGCGTC
TGTAAAGACTCGGTCTGGA -> GTAAAGACTCGGTCTGGAC
CCGTGTGTTGTCCGGCGCG -> CGTGTGTTGTCCGGCGCGG
GGCATTAGAGACTTAGAAG -> GCATTAGAGACTTAGAAGA
ATCACAGTGGCCGAGGACT -> TCACAGTGGCCGAGGACTC
TGGTACCTAGTTGTCCGCT -> GGTACCTAGTTGTCCGCTT
TATAGGTTTGACGGTAGCT -> ATAGGTTTGACGGTAGCTC
CGACGAGTGTTAGACGACC -> GACGAGTGTTAGACGACCA
CTTAGCGTAGCAACTGCGG -> TTAGCGTAGCAACTGCGGC
TGAGAAATACGTTACGTTA -> GAGAAATACGTTACGTTAT
TGGATCTCCATAAGAAAAG -> GGATCTCCATAAGAAAAGT
CTCGCGGAGCCCCGACGAG -> TCGCGGAGCCCCGACGAGT
CCCACATTGCACGTCTCGG -> CCACATTGCACGTCTCGGC
CTGCACTGCCCTAAACCTG -> TGCACTGCCCTAAACCTGG
GGACCCCGCGATTTACTTC -> GACCCCGCGATTTACTTCA
TCAGATACTCCTTCCCGGG -> CAGATACTCCTTCCCGGGG
CCATTGGATACTTAGTTCC -> CATTGGATACTTAGTTCCT
CTTCACTGCCGGTGCTCCT -> TTCACTGCCGGTGCTCCTT
ACATGCTTGCTGTCCGCGC -> CATGCTTGCTGTCCGCGCT
TGTTAGGCTATGATTGAGC -> GTTAGGCTATGATTGAGCG
CCCCAAATATTCAGGAATG -> CCCAAATATTCAGGAATGA
TGTATGTCATTGACCTCCG -> GTATGTCATTGACCTCCGT
TAAGCCGTCGTTCTGCCGT -> AAGCCGTCGTTCTGCCGTG
GTATAGATGCCGTTAATAG -> TATAGATGCCGTTAATAGC
ACTTAGTATGTGGTACTCC -> CTTAGTATGTGGTACTCCT
GTAGGCGTCTTGACTCTCA -> TAGGCGTCTTGACTCTCAT
CGGTGGTGAGAAATACGTT -> GGTGGTGAGAAATACGTTA
TAGGCCTCTTGCTCGTACT -> AGGCCTCTTGCTCGTACTT
ATCCGAATATTGCTATGAC -> TCCGAATATTGCTATGACG
GCACCAGACGACGCTATGT -> CACCAGACGACGCTATGTT
CAAGCCCGGCAATTCAAGT -> AAGCCCGGCAATTCAAGTG
CCGTAGTCGCGGGACTGGA -> CGTAGTCGCGGGACTGGAT
TCCGGTCGAGACCAAACTG -> CCGGTCGAGACCAAACTGT
TTAGATGACGGTGCCCTAC -> TAGATGACGGTGCCCTACG
ATTTTGGCAGGAACCCAGA -> TTTTGGCAGGAACCCAGAT
CCAAGATTTTTCCCTCATT -> CAAGATTTTTCCCTCATTG
TAAAATTACTCTGACTTAG -> AAAATTACTCTGACTTAGT
CAGCCCTCCCCCGTCTTTA -> AGCCCTCCCCCGTCTTTAG
GCTCGTACTTGAGCGCGTC -> CTCGTACTTGAGCGCGTCC
TACGGCACTAAGGAGACCC -> ACGGCACTAAGGAGACCCA
AACTCTTGGGTTCAGGAAT -> ACTCTTGGGTTCAGGAATG
GTGAAGGCGAAGAAGGAGA -> TGAAGGCGAAGAAGGAGAC
TTCAGGAATGAGGCATTCG -> TCAGGAATGAGGCATTCGT
GACCCCGTCCTTATTTTGG -> ACCCCGTCCTTATTTTGGC
TATAGATGCCGTTAATAGC -> ATAGATGCCGTTAATAGCG
TAGATGACGGTGCCCTACG -> AGATGACGGTGCCCTACGT
CCCACTCCGCTGAGGAACC -> CCACTCCGCTGAGGAACCA
AAGTAGGGCTCCACCACAT -> AGTAGGGCTCCACCACATG
TGAATAGCGTTGAGTTACA -> GAATAGCGTTGAGTTACAG
TACGGTCGTTTCCGGTCGA -> ACGGTCGTTTCCGGTCGAG
GGGATCGCGGCGGACAAGT -> GGATCGCGGCGGACAAGTA
GAGACCCATAGCTTCATAA -> AGACCCATAGCTTCATAAA, AGACCCATAGCTTCATAAG
ATGTAAGCCGTCGTTCTGC -> TGTAAGCCGTCGTTCTGCC
GCCGTCGTTCTGCCGTGGG -> CCGTCGTTCTGCCGTGGGC
ATCGCGGCGGACAAGTATC -> TCGCGGCGGACAAGTATCC
AACCCAGATACGGTTCATA -> ACCCAGATACGGTTCATAC
TAGCTTCATAAAACCTCCA -> AGCTTCATAAAACCTCCAG
ACTTGCTACTATGAGAGCA -> CTTGCTACTATGAGAGCAG
TGGGGAACATGCTTGCTGT -> GGGGAACATGCTTGCTGTC
GCCGTGGGCGAGAGTTTCT -> CCGTGGGCGAGAGTTTCTC
TTAGGCTATGATTGAGCGT -> TAGGCTATGATTGAGCGTT
TTACAGCCAATTGCTAACG -> TACAGCCAATTGCTAACGG
AGCTTCATTTCGAAAAGAA -> GCTTCATTTCGAAAAGAAC
ATGAGGCATTCTATGCCCG -> TGAGGCATTCTATGCCCGC
CTGTAAAGACTCGGTCTGG -> TGTAAAGACTCGGTCTGGA
TTTCGTTACGGTCGTTTCC -> TTCGTTACGGTCGTTTCCG
CGTTGAGTTACAGCCAATT -> GTTGAGTTACAGCCAATTG
GTACCTAGTTGTCCGCTTT -> TACCTAGTTGTCCGCTTTT
ACTTGTTTCGCCGATCGAT -> CTTGTTTCGCCGATCGATG
GCTTAGCGTAGCAACTGCG -> CTTAGCGTAGCAACTGCGG
ATAGATGCCGTTAATAGCG -> TAGATGCCGTTAATAGCGC
CGTCGTTCTGCCGTGGGCG -> GTCGTTCTGCCGTGGGCGA
GTGGTGAGAAATACGTTAC -> TGGTGAGAAATACGTTACG
GACTTAGAAGACGCTAGCT -> ACTTAGAAGACGCTAGCTG
ATAGCTTCATAAGACGGCG -> TAGCTTCATAAGACGGCGA
GTGCCGTATCATGGGACCG -> TGCCGTATCATGGGACCGG
TTGCTGTCCGCGCTACTCG -> TGCTGTCCGCGCTACTCGA
TTGAAGTAGGGCTCCACCA -> TGAAGTAGGGCTCCACCAC
TGTTGTCCGGCGCGGACTA -> GTTGTCCGGCGCGGACTAT
GGGCCTTGACGCTGTCCGG -> GGCCTTGACGCTGTCCGGG
GTCTCGGCACGCACATTAA -> TCTCGGCACGCACATTAAG
GCTTCATAAGACGGCGATG -> CTTCATAAGACGGCGATGC
TTTTCCCTCATTGTGAGTC -> TTTCCCTCATTGTGAGTCT
CTCTGCACTGCCCTAAACC -> TCTGCACTGCCCTAAACCT
ACTCCTTCCCGGGGTCCCG -> CTCCTTCCCGGGGTCCCGG
AGGCTATGATTGAGCGTTT -> GGCTATGATTGAGCGTTTG
CGGCTGCTATTTGTGCCCG -> GGCTGCTATTTGTGCCCGC
CCGTTAATAGCGCAGTCCA -> CGTTAATAGCGCAGTCCAC
CGAGACCAAACTGTGGGAC -> GAGACCAAACTGTGGGACT
GACTTGGGCCTTGACGCTG -> ACTTGGGCCTTGACGCTGT
GTTGCCCACATTGCACGTC -> TTGCCCACATTGCACGTCT
ACTCCACAGGTGCCAGCTA -> CTCCACAGGTGCCAGCTAA
TTCAGGAATGAGGCATTCC -> TCAGGAATGAGGCATTCCG
ACGCTAGTAAGGAGCTTCG -> CGCTAGTAAGGAGCTTCGA
TCGAACTGCTCTGTTACTT -> CGAACTGCTCTGTTACTTC
GAAGAAGGAGACTTCACCA -> AAGAAGGAGACTTCACCAG
TACTCTGACTTAGTATGTG -> ACTCTGACTTAGTATGTGG
TCCCCGTGTGTTGTCCGGC -> CCCCGTGTGTTGTCCGGCG
CGCCGATCGATGGCCAATT -> GCCGATCGATGGCCAATTA
GCTGAGGAACCACTACCCC -> CTGAGGAACCACTACCCCA
GTGAGAAATACGTTACGTT -> TGAGAAATACGTTACGTTA
TCGTTCTGCCGTGGGCGAG -> CGTTCTGCCGTGGGCGAGA
ACTGTGGGACTTGGGCCTT -> CTGTGGGACTTGGGCCTTG
CGAAAAGAACGACTCAAGC -> GAAAAGAACGACTCAAGCG
CGGGTTCTAAGCTTAGCGT -> GGGTTCTAAGCTTAGCGTA
TGCTATGACGCCCTCAATG -> GCTATGACGCCCTCAATGT
GTTAATAGCGCAGTCCACA -> TTAATAGCGCAGTCCACAG
CGGCACTAAGGAGACCCAT -> GGCACTAAGGAGACCCATA
TAGCTTCATTTCGAAAAGA -> AGCTTCATTTCGAAAAGAA
AGCTAGTTGCCCACATTGC -> GCTAGTTGCCCACATTGCA
GCAACGACACCCGTAGTCG -> CAACGACACCCGTAGTCGC
TAGTAAGGAGCTTCGAACT -> AGTAAGGAGCTTCGAACTG
GCCCGCTTGCCCTCCCTCA -> CCCGCTTGCCCTCCCTCAT
CTATTAACAGGACAGCGTT -> TATTAACAGGACAGCGTTG
GTCCTTATTTTGGCAGGAA -> TCCTTATTTTGGCAGGAAC
GGTTACAGCCCTCCCCCGT -> GTTACAGCCCTCCCCCGTC
ACTTGGGCCTTGACGCTGT -> CTTGGGCCTTGACGCTGTC
ATTAAAACCGTGCACCAGA -> TTAAAACCGTGCACCAGAC
AGTCCACAGGGAGGAGGGG -> GTCCACAGGGAGGAGGGGA
GACGGTAGCTCAGGGCTTG -> ACGGTAGCTCAGGGCTTGT
GAGGCATTCGTACGGCACT -> AGGCATTCGTACGGCACTA
CTGTCCGGGAAACTGACTG -> TGTCCGGGAAACTGACTGG
AGGACACCCGCACCAACCA -> GGACACCCGCACCAACCAT
ACAAGGGGATCGCGGCGGA -> CAAGGGGATCGCGGCGGAC
GTATGTCATTGACCTCCGT -> TATGTCATTGACCTCCGTT
CCGCTTTTAGCCACTAGGC -> CGCTTTTAGCCACTAGGCC
TATCAGATACTCCTTCCCG -> ATCAGATACTCCTTCCCGG
TTAAGGACGGCGCAACAGA -> TAAGGACGGCGCAACAGAC
GGCGAGAGTTTCTCCTGTT -> GCGAGAGTTTCTCCTGTTA
CAGATACTCCTTCCCGGGG -> AGATACTCCTTCCCGGGGT
CCTCTGCCAAGGAGACCCA -> CTCTGCCAAGGAGACCCAT
CCGTCTTTAGGACACCCGC -> CGTCTTTAGGACACCCGCA
TAATCCCACGAGATCCTGA -> AATCCCACGAGATCCTGAG
ACCAACCATAGGAAGGACC -> CCAACCATAGGAAGGACCG
GCCGTATCATGGGACCGGT -> CCGTATCATGGGACCGGTA
GGCACGCACATTAAGGACG -> GCACGCACATTAAGGACGG
AGAGTTGTCTATATTGAAG -> GAGTTGTCTATATTGAAGT
CGTATCATGGGACCGGTAT -> GTATCATGGGACCGGTATC
TTGCTATGACGCCCTCAAT -> TGCTATGACGCCCTCAATG
ATTGAAGTAGGGCTCCACC -> TTGAAGTAGGGCTCCACCA
CCGACTGGTGCACTAACTG -> CGACTGGTGCACTAACTGT
GTGCTCCTTTTAGCTACAA -> TGCTCCTTTTAGCTACAAT
TAACATGGGGAACATGCTT -> AACATGGGGAACATGCTTG
TACAGTTTCTATAATACCA -> ACAGTTTCTATAATACCAT
CATGCTTGCTGTCCGCGCT -> ATGCTTGCTGTCCGCGCTA
GATTAAGAGTCTGATTTAG -> ATTAAGAGTCTGATTTAGA
GGGTACAGTTTCTATAATA -> GGTACAGTTTCTATAATAC
TCATGGGACCGGTATCCCT -> CATGGGACCGGTATCCCTA
TTGCTAACGGGACCCCGTC -> TGCTAACGGGACCCCGTCC
TCCTGTTAGCGTTAGCTAG -> CCTGTTAGCGTTAGCTAGT
CGCCTGACGCCTCGCGGAG -> GCCTGACGCCTCGCGGAGC
TAAGATCACGCACCTGCAC -> AAGATCACGCACCTGCACT
GCTCCGGAACGCGGTGAGT -> CTCCGGAACGCGGTGAGTT
ATGTTAGGCTATGATTGAG -> TGTTAGGCTATGATTGAGC
CGTTGGCTCAGATACGAGC -> GTTGGCTCAGATACGAGCG
GATGGCCAATTACGTGGAG -> ATGGCCAATTACGTGGAGG
CTTGACTCTCATCAGGGTA -> TTGACTCTCATCAGGGTAC
GGCCAATTACGTGGAGGCT -> GCCAATTACGTGGAGGCTG
CGCGGTGAGTTCACTATGC -> GCGGTGAGTTCACTATGCT
AGTTCAGGATTTAGAGCGG -> GTTCAGGATTTAGAGCGGT
CCCGTAGTCGCGGGACTGG -> CCGTAGTCGCGGGACTGGA
GCGGACTATTAACAGGACA -> CGGACTATTAACAGGACAG
TTGACCGACTGGTGCACTA -> TGACCGACTGGTGCACTAA
TCGCGGAGCCCCGACGAGT -> CGCGGAGCCCCGACGAGTG
GGACTTGGGCCTTGACGCT -> GACTTGGGCCTTGACGCTG
TTCAGGATTTAGAGCGGTT -> TCAGGATTTAGAGCGGTTC
GAGTAAAAGAGTAGCTCAT -> AGTAAAAGAGTAGCTCATT
GTCTTACTTGTTTCGCCGA -> TCTTACTTGTTTCGCCGAT
AGGCGTCTTGACTCTCATC -> GGCGTCTTGACTCTCATCA
ACTATGAGAGCAGTCTTAC -> CTATGAGAGCAGTCTTACT
GCCCACTCCGCTGAGGAAC -> CCCACTCCGCTGAGGAACC
GGCGTCATCGTAGTCGCCA -> GCGTCATCGTAGTCGCCAA
AAATATGGTATAGATGCCG -> AATATGGTATAGATGCCGT
GTCTTTGAATAGCGTTGAG -> TCTTTGAATAGCGTTGAGT
ACTGGATTAAGAGTCTGAT -> CTGGATTAAGAGTCTGATT
CGGGACCCCGTCCTTATTT -> GGGACCCCGTCCTTATTTT
TGTTGGATTAAAACCGTGC -> GTTGGATTAAAACCGTGCA
GAGAGCAGTCTTACTTGTT -> AGAGCAGTCTTACTTGTTT
ACAGCGCAAGCCCGGCAAT -> CAGCGCAAGCCCGGCAATT
CCGACGAGTGTTAGACGAC -> CGACGAGTGTTAGACGACC
TATGAGAGCAGTCTTACTT -> ATGAGAGCAGTCTTACTTG
ATCACGCACCTGCACTGCA -> TCACGCACCTGCACTGCAA
TGGGACCGGTATCCCTACG -> GGGACCGGTATCCCTACGA
GCTCACCGTGCCGTATCAT -> CTCACCGTGCCGTATCATG
AAGCTTAGCGTAGCAACTG -> AGCTTAGCGTAGCAACTGC
CCACAGGTGCCAGCTAACT -> CACAGGTGCCAGCTAACTG
TCATCGTAGTCGCCAAATA -> CATCGTAGTCGCCAAATAT
TCAGATACGAGCGCCTGAC -> CAGATACGAGCGCCTGACG
TGGATAAGATCACGCACCT -> GGATAAGATCACGCACCTG
CTCAATGTCAAGGCGGTCT -> TCAATGTCAAGGCGGTCTG
AGGGGACTTGACCGACTGG -> GGGGACTTGACCGACTGGT
TGGATTAAAACCGTGCACC -> GGATTAAAACCGTGCACCA
TTCTAAGCTTAGCGTAGCA -> TCTAAGCTTAGCGTAGCAA
GAGGCTGCGTTGTATGTCA -> AGGCTGCGTTGTATGTCAT
AGTAACATGGGGAACATGC -> GTAACATGGGGAACATGCT
CTCGGTCTGGACGTTGCCT -> TCGGTCTGGACGTTGCCTT
GACGGCGATGCGAAGTTAT -> ACGGCGATGCGAAGTTATC
GCGAAGTTATCAGATACTC -> CGAAGTTATCAGATACTCC
GACAACCGACGCTAATGCT -> ACAACCGACGCTAATGCTA
TAGCTTCATTGTGCGGTGA -> AGCTTCATTGTGCGGTGAC
GCTCCTTTTAGCTACAATT -> CTCCTTTTAGCTACAATTG
ACCCATAGCTTCATAAGAC -> CCCATAGCTTCATAAGACG
ACGGACCCCGCGATTTACT -> CGGACCCCGCGATTTACTT
CAAGGGGATCGCGGCGGAC -> AAGGGGATCGCGGCGGACA
CTCACCGTGCCGTATCATG -> TCACCGTGCCGTATCATGG
GAGAGTTTCTCCTGTTAGC -> AGAGTTTCTCCTGTTAGCG
GGCGAAGAAGGAGACTTCA -> GCGAAGAAGGAGACTTCAC
GCAGGAACCCAGATACGGT -> CAGGAACCCAGATACGGTT
TGACTTAGTATGTGGTACT -> GACTTAGTATGTGGTACTC
TGCCAATAAAATTACTCTG -> GCCAATAAAATTACTCTGA
TAATGCTATTTGTATATAG -> AATGCTATTTGTATATAGG
GATCGATGGCCAATTACGT -> ATCGATGGCCAATTACGTG
TAAAACCTCCAGACGGGGC -> AAAACCTCCAGACGGGGCT
TTAGCTAGTTGCCCACATT -> TAGCTAGTTGCCCACATTG
CATTTCGAAAAGAACGACT -> ATTTCGAAAAGAACGACTC
CAGATACGAGCGCCTGACG -> AGATACGAGCGCCTGACGC
AACAAGGGGATCGCGGCGG -> ACAAGGGGATCGCGGCGGA
GGACTGGATTAAGAGTCTG -> GACTGGATTAAGAGTCTGA
TTAAGAGTCTGATTTAGAT -> TAAGAGTCTGATTTAGATG
CGACGCTATGTTAGGCTAT -> GACGCTATGTTAGGCTATG
TATGTCATTGACCTCCGTT -> ATGTCATTGACCTCCGTTC
AAGTGAAGGCGAAGAAGGA -> AGTGAAGGCGAAGAAGGAG
CTCCGGAACGCGGTGAGTT -> TCCGGAACGCGGTGAGTTC
CAACTGCGGCATTAGAGAC -> AACTGCGGCATTAGAGACT
TCCACAGGTGCCAGCTAAC -> CCACAGGTGCCAGCTAACT
GGTACCTAGTTGTCCGCTT -> GTACCTAGTTGTCCGCTTT
GGGAAACTGACTGGATAAG -> GGAAACTGACTGGATAAGA
GCTGCTATTTGTGCCCGCT -> CTGCTATTTGTGCCCGCTT
TGCAACGACACCCGTAGTC -> GCAACGACACCCGTAGTCG
CTAACGGGACCCCGTCCTT -> TAACGGGACCCCGTCCTTA
GCGCGGACTATTAACAGGA -> CGCGGACTATTAACAGGAC
TTCAGGAATGAGGCATTCA -> TCAGGAATGAGGCATTCAC
ATATTGCTATGACGCCCTC -> TATTGCTATGACGCCCTCA
GACCCCGCGATTTACTTCA -> ACCCCGCGATTTACTTCAT
CCCATAGCTTCATAAAACC -> CCATAGCTTCATAAAACCT
CGGTTACAGCCCTCCCCCG -> GGTTACAGCCCTCCCCCGT
TTATTAGGTATTTCAGGAA -> TATTAGGTATTTCAGGAAT
GGGACCGGTATCCCTACGA -> GGACCGGTATCCCTACGAT
GGTCGAGACCAAACTGTGG -> GTCGAGACCAAACTGTGGG
CCCACGAGATCCTGAGCCC -> CCACGAGATCCTGAGCCCA
AAGAAAAGTGATAGAGTAG -> AGAAAAGTGATAGAGTAGA
TAATAGCGCAGTCCACAGG -> AATAGCGCAGTCCACAGGG
ACTCTGACTTAGTATGTGG -> CTCTGACTTAGTATGTGGT
ATACCATTGGATACTTAGT -> TACCATTGGATACTTAGTT
GTGAGTCTTTGAATAGCGT -> TGAGTCTTTGAATAGCGTT
TAACTGTAAAGACTCGGTC -> AACTGTAAAGACTCGGTCT
ACTGGATAAGATCACGCAC -> CTGGATAAGATCACGCACC
AATAAAATTACTCTGACTT -> ATAAAATTACTCTGACTTA
CTCATCAGGGTACAGTTTC -> TCATCAGGGTACAGTTTCT
CACGTCTCGGCACGCACAT -> ACGTCTCGGCACGCACATT
GGATACTTAGTTCCTGGAA -> GATACTTAGTTCCTGGAAC
TGCGGCATTAGAGACTTAG -> GCGGCATTAGAGACTTAGA
GGAATGAGGCATTCGTACG -> GAATGAGGCATTCGTACGG
AGAGTAAAAGAGTAGCTCA -> GAGTAAAAGAGTAGCTCAT
ACGCTATGTTAGGCTATGA -> CGCTATGTTAGGCTATGAT
GTTGTCTATATTGAAGTAG -> TTGTCTATATTGAAGTAGG
GCTTCGCCGACGAGGCTGC -> CTTCGCCGACGAGGCTGCG
GTAGGGCTCCACCACATGG -> TAGGGCTCCACCACATGGT
TACAGCGCAAGCCCGGCAA -> ACAGCGCAAGCCCGGCAAT
TTTGGCAGGAACCCAGATA -> TTGGCAGGAACCCAGATAC
CACTATGCTACATAAGCTT -> ACTATGCTACATAAGCTTC
GAGTCTGATTTAGATGACG -> AGTCTGATTTAGATGACGG
TAGTTCCTGGAACAAGGGG -> AGTTCCTGGAACAAGGGGA
TTTCCCCGTGTGTTGTCCG -> TTCCCCGTGTGTTGTCCGG
TGACTGGATAAGATCACGC -> GACTGGATAAGATCACGCA
ACGGGACCCCGTCCTTATT -> CGGGACCCCGTCCTTATTT
AGGAAGGACCGCGCACAGA -> GGAAGGACCGCGCACAGAA
TTCGCCGATCGATGGCCAA -> TCGCCGATCGATGGCCAAT
CAATAAAATTACTCTGACT -> AATAAAATTACTCTGACTT
GTCCGCTTTTAGCCACTAG -> TCCGCTTTTAGCCACTAGG
TGCACCAGACGACGCTATG -> GCACCAGACGACGCTATGT
CACTAACTGTAAAGACTCG -> ACTAACTGTAAAGACTCGG
TCGCCAAATATGGTATAGA -> CGCCAAATATGGTATAGAT
AGCTTCGCCGACGAGGCTG -> GCTTCGCCGACGAGGCTGC
CGCTGTCCGGGAAACTGAC -> GCTGTCCGGGAAACTGACT
ACGTTACGTTATACGGTGG -> CGTTACGTTATACGGTGGT
ACCAAGATTTTTCCCTCAT -> CCAAGATTTTTCCCTCATT
CGTTAATAGCGCAGTCCAC -> GTTAATAGCGCAGTCCACA
GGCTTGTTAGTTGCTACAC -> GCTTGTTAGTTGCTACACT
GCCTCGCGGAGCCCCGACG -> CCTCGCGGAGCCCCGACGA
CTATGCCCGCAAAGGAGAC -> TATGCCCGCAAAGGAGACC
CCGGTTACAGCCCTCCCCC -> CGGTTACAGCCCTCCCCCG
CCATAGCTTCATTGTGCGG -> CATAGCTTCATTGTGCGGT
TTTCCAAATGAGGTCCGCG -> TTCCAAATGAGGTCCGCGT
CTCCTGTTAGCGTTAGCTA -> TCCTGTTAGCGTTAGCTAG
GCATTCCGCCTCTGCCAAG -> CATTCCGCCTCTGCCAAGG
AAGACTTGCTACTATGAGA -> AGACTTGCTACTATGAGAG
CGGTCGAGACCAAACTGTG -> GGTCGAGACCAAACTGTGG
CATTAAGGACGGCGCAACA -> ATTAAGGACGGCGCAACAG
TTTTTCCCTCATTGTGAGT -> TTTTCCCTCATTGTGAGTC
ATCGTAGTCGCCAAATATG -> TCGTAGTCGCCAAATATGG
CGAGGCTGCGTTGTATGTC -> GAGGCTGCGTTGTATGTCA
CTCCTTTTAGCTACAATTG -> TCCTTTTAGCTACAATTGA
CACCGTGCCGTATCATGGG -> ACCGTGCCGTATCATGGGA
CCGGAACGCGGTGAGTTCA -> CGGAACGCGGTGAGTTCAC
TTAGTTGCTACACTCTCGG -> TAGTTGCTACACTCTCGGG
GGAGGCTGTCGCTCACCGT -> GAGGCTGTCGCTCACCGTG
GGAACATGCTTGCTGTCCG -> GAACATGCTTGCTGTCCGC
CCTGGAACAAGGGGATCGC -> CTGGAACAAGGGGATCGCG
TTTCTATAATACCATTGGA -> TTCTATAATACCATTGGAT
GACTCTCATCAGGGTACAG -> ACTCTCATCAGGGTACAGT
AACAGGACAGCGTTGGCTC -> ACAGGACAGCGTTGGCTCA
CCGCAAAGGAGACCCATAG -> CGCAAAGGAGACCCATAGC
CACAGAACATGAAAAGGGG -> ACAGAACATGAAAAGGGGA
ACGGCGCAACAGACCAAGA -> CGGCGCAACAGACCAAGAT
GAGACCCATAGCTTCATTG -> AGACCCATAGCTTCATTGT
TGAGGTCCGCGTAGGTTTA -> GAGGTCCGCGTAGGTTTAT
CTAACTGTAAAGACTCGGT -> TAACTGTAAAGACTCGGTC
CGTAGGTTTATGGATCTCA -> GTAGGTTTATGGATCTCAA
TGAAGGCGAAGAAGGAGAC -> GAAGGCGAAGAAGGAGACT
GTCTTTAGGACACCCGCAC -> TCTTTAGGACACCCGCACC
AACGACACCCGTAGTCGCG -> ACGACACCCGTAGTCGCGG
GCTGTCCGGGAAACTGACT -> CTGTCCGGGAAACTGACTG
GTACGGCACTAAGGAGACC -> TACGGCACTAAGGAGACCC
AATGAGGCATTCGTACGGC -> ATGAGGCATTCGTACGGCA
TCCGGGAAACTGACTGGAT -> CCGGGAAACTGACTGGATA
ATGGGACCGGTATCCCTAC -> TGGGACCGGTATCCCTACG
ATTCCGCCTCTGCCAAGGA -> TTCCGCCTCTGCCAAGGAG
AAAACCGTGCACCAGACGA -> AAACCGTGCACCAGACGAC
ATTGGATACTTAGTTCCTG -> TTGGATACTTAGTTCCTGG
TTTGACGGTAGCTCAGGGC -> TTGACGGTAGCTCAGGGCT
GCGGCATTAGAGACTTAGA -> CGGCATTAGAGACTTAGAA
CATTGTGCGGTGACTCTGC -> ATTGTGCGGTGACTCTGCA
GCGGTCTGCTGATGTATTA -> CGGTCTGCTGATGTATTAT
AGTTTCTATAATACCATTG -> GTTTCTATAATACCATTGG
GAAGACGCTAGCTGCAACG -> AAGACGCTAGCTGCAACGA
CGTAGTCGCGGGACTGGAT -> GTAGTCGCGGGACTGGATT
CTATAATACCATTGGATAC -> TATAATACCATTGGATACT
ACAGCGTTGGCTCAGATAC -> CAGCGTTGGCTCAGATACG
TCAGACCGAGTAACATGGG -> CAGACCGAGTAACATGGGG
ATTTTTCATTTGTTGGATT -> TTTTTCATTTGTTGGATTA
AGAGCAGTCTTACTTGTTT -> GAGCAGTCTTACTTGTTTC
CCACAGGGAGGAGGGGAGT -> CACAGGGAGGAGGGGAGTT
TGGTCATCCAGGGAGGACC -> GGTCATCCAGGGAGGACCT
TCTTTAGGACACCCGCACC -> CTTTAGGACACCCGCACCA
AGGCTGCGTTGTATGTCAT -> GGCTGCGTTGTATGTCATT
CCTCAATGTCAAGGCGGTC -> CTCAATGTCAAGGCGGTCT
GTATCATGGGACCGGTATC -> TATCATGGGACCGGTATCC
GAACTGCTCTGTTACTTCA -> AACTGCTCTGTTACTTCAG
AAAGTGATAGAGTAGAGTA -> AAGTGATAGAGTAGAGTAA
TTTAGATGACGGTGCCCTA -> TTAGATGACGGTGCCCTAC
TGTTTCGCCGATCGATGGC -> GTTTCGCCGATCGATGGCC
TTTTCCCCGTGTGTTGTCC -> TTTCCCCGTGTGTTGTCCG
AGGAATGAGGCATTCCGCC -> GGAATGAGGCATTCCGCCT
TTCCTGGAACAAGGGGATC -> TCCTGGAACAAGGGGATCG
TTCACCCTTCCGAGAGTTG -> TCACCCTTCCGAGAGTTGT
GGCAACTCTTGGGTTCAGG -> GCAACTCTTGGGTTCAGGA
ACCACTACCCCAAATATTC -> CCACTACCCCAAATATTCA
ACATGAAAAGGGGACTTGA -> CATGAAAAGGGGACTTGAC
GTGCCCGCTTGCCCTCCCT -> TGCCCGCTTGCCCTCCCTC
AGCCACTAGGCCTCTTGCT -> GCCACTAGGCCTCTTGCTC
AGGAACCACTACCCCAAAT -> GGAACCACTACCCCAAATA
TAGCTAGTTGCCCACATTG -> AGCTAGTTGCCCACATTGC
TATTTGTGCCCGCTTGCCC -> ATTTGTGCCCGCTTGCCCT
TCGAAAAGAACGACTCAAG -> CGAAAAGAACGACTCAAGC
CCACATTGCACGTCTCGGC -> CACATTGCACGTCTCGGCA
TAGAAGACGCTAGCTGCAA -> AGAAGACGCTAGCTGCAAC
ATATGGTATAGATGCCGTT -> TATGGTATAGATGCCGTTA
ACCATTGGATACTTAGTTC -> CCATTGGATACTTAGTTCC
GCGGTGACTCTGCACTGCC -> CGGTGACTCTGCACTGCCC
CCAAATATTCAGGAATGAG -> CAAATATTCAGGAATGAGG
TGTGGGACTTGGGCCTTGA -> GTGGGACTTGGGCCTTGAC
CATGAAAAGGGGACTTGAC -> ATGAAAAGGGGACTTGACC
GGGACTTGGGCCTTGACGC -> GGACTTGGGCCTTGACGCT
ACTCGGTTCACCCTTCCGA -> CTCGGTTCACCCTTCCGAG
ACAGCCCTCCCCCGTCTTT -> CAGCCCTCCCCCGTCTTTA
CGAAGAAGGAGACTTCACC -> GAAGAAGGAGACTTCACCA
CCCGCGATTTACTTCATGG -> CCGCGATTTACTTCATGGA
GACTTGCTACTATGAGAGC -> ACTTGCTACTATGAGAGCA
GATGATGTAAGCCGTCGTT -> ATGATGTAAGCCGTCGTTC
GTATTATTAGGTATTTCAG -> TATTATTAGGTATTTCAGG
AATGTCAAGGCGGTCTGCT -> ATGTCAAGGCGGTCTGCTG
TCACAGTGGCCGAGGACTC -> CACAGTGGCCGAGGACTCC
AACAGACCAAGATTTTTCC -> ACAGACCAAGATTTTTCCC
TGAGCGCGTCCAACGGACC -> GAGCGCGTCCAACGGACCC
AATTACGTGGAGGCTGTCG -> ATTACGTGGAGGCTGTCGC
TAGGGCTCCACCACATGGT -> AGGGCTCCACCACATGGTC
CGTCCTTATTTTGGCAGGA -> GTCCTTATTTTGGCAGGAA
TTTTAGCCACTAGGCCTCT -> TTTAGCCACTAGGCCTCTT
GGATAAGATCACGCACCTG -> GATAAGATCACGCACCTGC
GCGATGCGAAGTTATCAGA -> CGATGCGAAGTTATCAGAT
ACGGTAGCTCAGGGCTTGT -> CGGTAGCTCAGGGCTTGTT
ACCGGCGTCATCGTAGTCG -> CCGGCGTCATCGTAGTCGC
CTTCGAACTGCTCTGTTAC -> TTCGAACTGCTCTGTTACT
TCCGCTGAGGAACCACTAC -> CCGCTGAGGAACCACTACC
GACCAAGATTTTTCCCTCA -> ACCAAGATTTTTCCCTCAT
GGTATTTCAGGAATGAGGC -> GTATTTCAGGAATGAGGCA
GGAACAAGGGGATCGCGGC -> GAACAAGGGGATCGCGGCG
CTATGAGAGCAGTCTTACT -> TATGAGAGCAGTCTTACTT
CTTGCCCTCCCTCATCATC -> TTGCCCTCCCTCATCATCC
CTGTTACTTCAGGAATGAG -> TGTTACTTCAGGAATGAGG
AGCTTCGAACTGCTCTGTT -> GCTTCGAACTGCTCTGTTA
GCAACAGACCAAGATTTTT -> CAACAGACCAAGATTTTTC
AGGGGAGTTCAGGATTTAG -> GGGGAGTTCAGGATTTAGA
CACCACATGGTCATCCAGG -> ACCACATGGTCATCCAGGG
GACACCCGTAGTCGCGGGA -> ACACCCGTAGTCGCGGGAC
CTTGCTGTCCGCGCTACTC -> TTGCTGTCCGCGCTACTCG
TCCCCCGTCTTTAGGACAC -> CCCCCGTCTTTAGGACACC
TGTCCGCGCTACTCGACAA -> GTCCGCGCTACTCGACAAC
CACTGCAACCGGCGTCATC -> ACTGCAACCGGCGTCATCG
AAACCTCCAGACGGGGCTC -> AACCTCCAGACGGGGCTCC
TTTACTTCATGGATCTCCA -> TTACTTCATGGATCTCCAT
CTACATAAGCTTCGCCGAC -> TACATAAGCTTCGCCGACG
AAAAGAGTAGCTCATTTAC -> AAAGAGTAGCTCATTTACT
GGCGGTCTGCTGATGTATT -> GCGGTCTGCTGATGTATTA
AGAGTAGAGTAAAAGAGTA -> GAGTAGAGTAAAAGAGTAG
CAGGACAGCGTTGGCTCAG -> AGGACAGCGTTGGCTCAGA
TTACTCTGACTTAGTATGT -> TACTCTGACTTAGTATGTG
AACCACTACCCCAAATATT -> ACCACTACCCCAAATATTC
GGCCTTGACGCTGTCCGGG -> GCCTTGACGCTGTCCGGGA
GACCGACTGGTGCACTAAC -> ACCGACTGGTGCACTAACT
CGAGTTACGCTAGTAAGGA -> GAGTTACGCTAGTAAGGAG
TGGCCGAGGACTCCACAGG -> GGCCGAGGACTCCACAGGT
TTCATAAAACCTCCAGACG -> TCATAAAACCTCCAGACGG
ACGATAGAGGATCACAGTG -> CGATAGAGGATCACAGTGG
TGGACGTTGCCTTTCCAAA -> GGACGTTGCCTTTCCAAAT
ACGTCGATGATGTAAGCCG -> CGTCGATGATGTAAGCCGT
GTTCAGGAATGAGGCATTC -> TTCAGGAATGAGGCATTCG
AGATACGGTTCATACCTTT -> GATACGGTTCATACCTTTA
TTAGGTATTTCAGGAATGA -> TAGGTATTTCAGGAATGAG
ATAGGAAGGACCGCGCACA -> TAGGAAGGACCGCGCACAG
ATTTGTGCCCGCTTGCCCT -> TTTGTGCCCGCTTGCCCTC
GTTTCCGGTCGAGACCAAA -> TTTCCGGTCGAGACCAAAC
GTCGCCAAATATGGTATAG -> TCGCCAAATATGGTATAGA
CCGGTCGAGACCAAACTGT -> CGGTCGAGACCAAACTGTG
TTGGATACTTAGTTCCTGG -> TGGATACTTAGTTCCTGGA
ATTGCACGTCTCGGCACGC -> TTGCACGTCTCGGCACGCA
AACCGTGCACCAGACGACG -> ACCGTGCACCAGACGACGC
GCTATGACGCCCTCAATGT -> CTATGACGCCCTCAATGTC
CAGTCCACAGGGAGGAGGG -> AGTCCACAGGGAGGAGGGG
CTCCAGACGGGGCTCCGGA -> TCCAGACGGGGCTCCGGAA
CGAGATCCTGAGCCCACTC -> GAGATCCTGAGCCCACTCC
CTCTTGCTCGTACTTGAGC -> TCTTGCTCGTACTTGAGCG
CTGAGCCCACTCCGCTGAG -> TGAGCCCACTCCGCTGAGG
CTGCTGATGTATTATTAGG -> TGCTGATGTATTATTAGGT
AAGGGGACTTGACCGACTG -> AGGGGACTTGACCGACTGG
GAGTGTTAGACGACCATTA -> AGTGTTAGACGACCATTAA
AGGAGCTTCGAACTGCTCT -> GGAGCTTCGAACTGCTCTG
AGAGGATCACAGTGGCCGA -> GAGGATCACAGTGGCCGAG
AGAACGACTCAAGCGTATT -> GAACGACTCAAGCGTATTT
CCTCCCTCATCATCCGAAT -> CTCCCTCATCATCCGAATA
GGGAGGACCTACTCACTTT -> GGAGGACCTACTCACTTTT
CCTCTTGCTCGTACTTGAG -> CTCTTGCTCGTACTTGAGC
TGGAGGCTGTCGCTCACCG -> GGAGGCTGTCGCTCACCGT
CTGTCTCTGTCCCTTCACT -> TGTCTCTGTCCCTTCACTG
CGTTCAGACCGAGTAACAT -> GTTCAGACCGAGTAACATG
ATGCCGTTAATAGCGCAGT -> TGCCGTTAATAGCGCAGTC
AAACTGTGGGACTTGGGCC -> AACTGTGGGACTTGGGCCT
CCGGCAATTCAAGTGAAGG -> CGGCAATTCAAGTGAAGGC
AGCCCCGACGAGTGTTAGA -> GCCCCGACGAGTGTTAGAC
ATGCTTGCTGTCCGCGCTA -> TGCTTGCTGTCCGCGCTAC
CTGTGGGACTTGGGCCTTG -> TGTGGGACTTGGGCCTTGA
CCTTTTAGCTACAATTGAC -> CTTTTAGCTACAATTGACG
TGGATCTCAAGACTTGCTA -> GGATCTCAAGACTTGCTAC
AGGTCCGCGTAGGTTTATG -> GGTCCGCGTAGGTTTATGG
TGGTACTCCTTACAGCGCA -> GGTACTCCTTACAGCGCAA
GCCCTCCCTCATCATCCGA -> CCCTCCCTCATCATCCGAA
CGGTGCCCTACGTCGATGA -> GGTGCCCTACGTCGATGAT
GAACGACTCAAGCGTATTT -> AACGACTCAAGCGTATTTT
CTCCCCCGTCTTTAGGACA -> TCCCCCGTCTTTAGGACAC
GTCTGGACGTTGCCTTTCC -> TCTGGACGTTGCCTTTCCA
TTGACTCTCATCAGGGTAC -> TGACTCTCATCAGGGTACA
TGGTGCACTAACTGTAAAG -> GGTGCACTAACTGTAAAGA
CAGCGCAAGCCCGGCAATT -> AGCGCAAGCCCGGCAATTC
CGTCGATGATGTAAGCCGT -> GTCGATGATGTAAGCCGTC
ATTTCGAAAAGAACGACTC -> TTTCGAAAAGAACGACTCA
GACTGGATAAGATCACGCA -> ACTGGATAAGATCACGCAC
TGTCCGGGAAACTGACTGG -> GTCCGGGAAACTGACTGGA
GGAGGGGAGTTCAGGATTT -> GAGGGGAGTTCAGGATTTA
GTGCCAGCTAACTGACGAG -> TGCCAGCTAACTGACGAGT
GGATTAAGAGTCTGATTTA -> GATTAAGAGTCTGATTTAG
GTCGATGATGTAAGCCGTC -> TCGATGATGTAAGCCGTCG
CCCCGTCTTTAGGACACCC -> CCCGTCTTTAGGACACCCG
GGAAGGACCGCGCACAGAA -> GAAGGACCGCGCACAGAAC
CTCGGGTTCTAAGCTTAGC -> TCGGGTTCTAAGCTTAGCG
TCCTTTTAGCTACAATTGA -> CCTTTTAGCTACAATTGAC
GTATCCATCGGCTGCTATT -> TATCCATCGGCTGCTATTT
TCGGTTCACCCTTCCGAGA -> CGGTTCACCCTTCCGAGAG
GCGGAGCCCCGACGAGTGT -> CGGAGCCCCGACGAGTGTT
CCCGCACCAACCATAGGAA -> CCGCACCAACCATAGGAAG
GACTTAGTATGTGGTACTC -> ACTTAGTATGTGGTACTCC
CCTGTTAGCGTTAGCTAGT -> CTGTTAGCGTTAGCTAGTT
CAAATATGGTATAGATGCC -> AAATATGGTATAGATGCCG
TAGCTTCATAAGACGGCGA -> AGCTTCATAAGACGGCGAT
ATAGAGTAGAGTAAAAGAG -> TAGAGTAGAGTAAAAGAGT
CACGAGTTATTAAGGAGAC -> ACGAGTTATTAAGGAGACC
CAAGGAGACCCATAGCTTC -> AAGGAGACCCATAGCTTCA
AGATGCCGTTAATAGCGCA -> GATGCCGTTAATAGCGCAG
CCCTTCACTGCCGGTGCTC -> CCTTCACTGCCGGTGCTCC
ACGAGTTATTAAGGAGACC -> CGAGTTATTAAGGAGACCC
GTCATCCAGGGAGGACCTA -> TCATCCAGGGAGGACCTAC
AGGAGACTTCACCAGCCTG -> GGAGACTTCACCAGCCTGT
ACTGCTCTGTTACTTCAGG -> CTGCTCTGTTACTTCAGGA
CCTTGACGCTGTCCGGGAA -> CTTGACGCTGTCCGGGAAA
GGAGACTTCACCAGCCTGT -> GAGACTTCACCAGCCTGTC
GATTAAAACCGTGCACCAG -> ATTAAAACCGTGCACCAGA
GGAGGAGGGGAGTTCAGGA -> GAGGAGGGGAGTTCAGGAT
AAATATTCAGGAATGAGGC -> AATATTCAGGAATGAGGCA
TGCACTGCAACCGGCGTCA -> GCACTGCAACCGGCGTCAT
CCGAGTAACATGGGGAACA -> CGAGTAACATGGGGAACAT
TAGCAACTGCGGCATTAGA -> AGCAACTGCGGCATTAGAG
GGTCCCGGTGGTGAGAAAT -> GTCCCGGTGGTGAGAAATA
TTGAGTTACAGCCAATTGC -> TGAGTTACAGCCAATTGCT
ACAGTGGCCGAGGACTCCA -> CAGTGGCCGAGGACTCCAC
AACGGACCCCGCGATTTAC -> ACGGACCCCGCGATTTACT
GGAACCCAGATACGGTTCA -> GAACCCAGATACGGTTCAT
CCTTATTTTGGCAGGAACC -> CTTATTTTGGCAGGAACCC
TGATAGAGTAGAGTAAAAG -> GATAGAGTAGAGTAAAAGA
GAGAAATACGTTACGTTAT -> AGAAATACGTTACGTTATA
TGGGGTAGGCGTCTTGACT -> GGGGTAGGCGTCTTGACTC
GAGGCATTCCGCCTCTGCC -> AGGCATTCCGCCTCTGCCA
TCGAGACCAAACTGTGGGA -> CGAGACCAAACTGTGGGAC
ACAGACCAAGATTTTTCCC -> CAGACCAAGATTTTTCCCT
GTTAGGCTATGATTGAGCG -> TTAGGCTATGATTGAGCGT
CGGCGTCATCGTAGTCGCC -> GGCGTCATCGTAGTCGCCA
AGCGCGTCCAACGGACCCC -> GCGCGTCCAACGGACCCCG
ATAGAGGATCACAGTGGCC -> TAGAGGATCACAGTGGCCG
ACTCTGCACTGCCCTAAAC -> CTCTGCACTGCCCTAAACC
CTTACAGCGCAAGCCCGGC -> TTACAGCGCAAGCCCGGCA
GGAAACTGACTGGATAAGA -> GAAACTGACTGGATAAGAT
CCTAAACCTGGTACCTAGT -> CTAAACCTGGTACCTAGTT
TCGCTCACCGTGCCGTATC -> CGCTCACCGTGCCGTATCA
GGGGTCCCGGTGGTGAGAA -> GGGTCCCGGTGGTGAGAAA
ATATTCAGGAATGAGGCAT -> TATTCAGGAATGAGGCATT
CAGGATTTAGAGCGGTTCA -> AGGATTTAGAGCGGTTCAC
TGAGGCATTCGTACGGCAC -> GAGGCATTCGTACGGCACT
TATGGATCTCAAGACTTGC -> ATGGATCTCAAGACTTGCT
AGCAGTCTTACTTGTTTCG -> GCAGTCTTACTTGTTTCGC
GAGGACTCCACAGGTGCCA -> AGGACTCCACAGGTGCCAG
AAGCGTATTTTTCATTTGT -> AGCGTATTTTTCATTTGTT
AGCAACTGCGGCATTAGAG -> GCAACTGCGGCATTAGAGA
GGTACAGTTTCTATAATAC -> GTACAGTTTCTATAATACC
TAAGGACGGCGCAACAGAC -> AAGGACGGCGCAACAGACC
GAGGAACCACTACCCCAAA -> AGGAACCACTACCCCAAAT
CCTACGTCGATGATGTAAG -> CTACGTCGATGATGTAAGC
CCATAGCTTCATAAGACGG -> CATAGCTTCATAAGACGGC
ACGGTCGTTTCCGGTCGAG -> CGGTCGTTTCCGGTCGAGA
CTGCCCTAAACCTGGTACC -> TGCCCTAAACCTGGTACCT
GTCCGGCGCGGACTATTAA -> TCCGGCGCGGACTATTAAC
ACGTCTCGGCACGCACATT -> CGTCTCGGCACGCACATTA
AGCGGTTCACCATCGCGGC -> GCGGTTCACCATCGCGGCA
ACGTTGCCTTTCCAAATGA -> CGTTGCCTTTCCAAATGAG
AGTAGGGCTCCACCACATG -> GTAGGGCTCCACCACATGG
CGAGTAACATGGGGAACAT -> GAGTAACATGGGGAACATG
AACTGACTGGATAAGATCA -> ACTGACTGGATAAGATCAC
TTAGAAGACGCTAGCTGCA -> TAGAAGACGCTAGCTGCAA
CGCGTCCAACGGACCCCGC -> GCGTCCAACGGACCCCGCG
TTCAGGAATGAGGCATTCT -> TCAGGAATGAGGCATTCTA
AGCCGTCGTTCTGCCGTGG -> GCCGTCGTTCTGCCGTGGG
AGTTTCTCCTGTTAGCGTT -> GTTTCTCCTGTTAGCGTTA
TCCGCGTAGGTTTATGGAT -> CCGCGTAGGTTTATGGATC
TTCTCCTGTTAGCGTTAGC -> TCTCCTGTTAGCGTTAGCT
CATTTGTTGGATTAAAACC -> ATTTGTTGGATTAAAACCG
GCACGCACATTAAGGACGG -> CACGCACATTAAGGACGGC
TAGTTGCCCACATTGCACG -> AGTTGCCCACATTGCACGT
TACTATGAGAGCAGTCTTA -> ACTATGAGAGCAGTCTTAC
AGTTATTAAGGAGACCCAT -> GTTATTAAGGAGACCCATA
GATCTCCATAAGAAAAGTG -> ATCTCCATAAGAAAAGTGA
CTCTCATCAGGGTACAGTT -> TCTCATCAGGGTACAGTTT
TTTACTTTCGTTACGGTCG -> TTACTTTCGTTACGGTCGT
CGCAACAGACCAAGATTTT -> GCAACAGACCAAGATTTTT
TCATCATCCGAATATTGCT -> CATCATCCGAATATTGCTA
AGGACGGCGCAACAGACCA -> GGACGGCGCAACAGACCAA
AGAACATGAAAAGGGGACT -> GAACATGAAAAGGGGACTT
AGGCATTCGTACGGCACTA -> GGCATTCGTACGGCACTAA
GTATATAGGTTTGACGGTA -> TATATAGGTTTGACGGTAG
GACGCTAATGCTATTTGTA -> ACGCTAATGCTATTTGTAT
AGTAGCTCATTTACTTTCG -> GTAGCTCATTTACTTTCGT
TCATTTGTTGGATTAAAAC -> CATTTGTTGGATTAAAACC
GCCAATAAAATTACTCTGA -> CCAATAAAATTACTCTGAC
ACTCTCATCAGGGTACAGT -> CTCTCATCAGGGTACAGTT
GTTAGCGTTAGCTAGTTGC -> TTAGCGTTAGCTAGTTGCC
GGGACCCCGTCCTTATTTT -> GGACCCCGTCCTTATTTTG
CTTAGTTCCTGGAACAAGG -> TTAGTTCCTGGAACAAGGG
ACTTCATGGATCTCCATAA -> CTTCATGGATCTCCATAAG
GCTATTTGTATATAGGTTT -> CTATTTGTATATAGGTTTG
ACCCAGATACGGTTCATAC -> CCCAGATACGGTTCATACC
GGATCGCGGCGGACAAGTA -> GATCGCGGCGGACAAGTAT
GCGTTGGCTCAGATACGAG -> CGTTGGCTCAGATACGAGC
TCTAAGCTTAGCGTAGCAA -> CTAAGCTTAGCGTAGCAAC
TATCCATCGGCTGCTATTT -> ATCCATCGGCTGCTATTTG
CCCGCAAAGGAGACCCATA -> CCGCAAAGGAGACCCATAG
AGTTGCCCACATTGCACGT -> GTTGCCCACATTGCACGTC
CATTGTGAGTCTTTGAATA -> ATTGTGAGTCTTTGAATAG
AACTGTAAAGACTCGGTCT -> ACTGTAAAGACTCGGTCTG
GAAGGAGACTTCACCAGCC -> AAGGAGACTTCACCAGCCT
TTCATACCTTTACTCGGTT -> TCATACCTTTACTCGGTTC
GGCACTAAGGAGACCCATA -> GCACTAAGGAGACCCATAG
GCGCACAGAACATGAAAAG -> CGCACAGAACATGAAAAGG
TTGCCAATAAAATTACTCT -> TGCCAATAAAATTACTCTG
ACACCCGTAGTCGCGGGAC -> CACCCGTAGTCGCGGGACT
ACCCTTCCGAGAGTTGTCT -> CCCTTCCGAGAGTTGTCTA
GTGGAGGCTGTCGCTCACC -> TGGAGGCTGTCGCTCACCG
TTACGTGGAGGCTGTCGCT -> TACGTGGAGGCTGTCGCTC
TATGCTACATAAGCTTCGC -> ATGCTACATAAGCTTCGCC
AGGAATGAGGCATTCGTAC -> GGAATGAGGCATTCGTACG
CCTAGTTGTCCGCTTTTAG -> CTAGTTGTCCGCTTTTAGC
AGAAGACGCTAGCTGCAAC -> GAAGACGCTAGCTGCAACG
TAAGACGGCGATGCGAAGT -> AAGACGGCGATGCGAAGTT
GGTAGCTCAGGGCTTGTTA -> GTAGCTCAGGGCTTGTTAG
GTAACATGGGGAACATGCT -> TAACATGGGGAACATGCTT
GATGCGAAGTTATCAGATA -> ATGCGAAGTTATCAGATAC
CGACTCAAGCGTATTTTTC -> GACTCAAGCGTATTTTTCA
TTGCTACACTCTCGGGTTC -> TGCTACACTCTCGGGTTCT
CTGGTACCTAGTTGTCCGC -> TGGTACCTAGTTGTCCGCT
CCCATAGCTTCATTTCGAA -> CCATAGCTTCATTTCGAAA
TGGTATAGATGCCGTTAAT -> GGTATAGATGCCGTTAATA
TAGGTATTTCAGGAATGAG -> AGGTATTTCAGGAATGAGG
AAGCCGTCGTTCTGCCGTG -> AGCCGTCGTTCTGCCGTGG
GCTTGCTGTCCGCGCTACT -> CTTGCTGTCCGCGCTACTC
CAGACGACGCTATGTTAGG -> AGACGACGCTATGTTAGGC
AGGGCTCCACCACATGGTC -> GGGCTCCACCACATGGTCA
CTGTCCCTTCACTGCCGGT -> TGTCCCTTCACTGCCGGTG
CATTCCGCCTCTGCCAAGG -> ATTCCGCCTCTGCCAAGGA
TTTTGGCAGGAACCCAGAT -> TTTGGCAGGAACCCAGATA
GAACGCGGTGAGTTCACTA -> AACGCGGTGAGTTCACTAT
TCAGGAATGAGGCATTCTA -> CAGGAATGAGGCATTCTAT
TCCAGACGGGGCTCCGGAA -> CCAGACGGGGCTCCGGAAC
CAGTCTTACTTGTTTCGCC -> AGTCTTACTTGTTTCGCCG
TATTAACAGGACAGCGTTG -> ATTAACAGGACAGCGTTGG
TGCCCTCCCTCATCATCCG -> GCCCTCCCTCATCATCCGA
ATTTACTTTCGTTACGGTC -> TTTACTTTCGTTACGGTCG
TCCACAGGGAGGAGGGGAG -> CCACAGGGAGGAGGGGAGT
ATTCTATGCCCGCAAAGGA -> TTCTATGCCCGCAAAGGAG
TTAGACGACCATTAATCCC -> TAGACGACCATTAATCCCA
GCCTCTGCCAAGGAGACCC -> CCTCTGCCAAGGAGACCCA
CATCGTAGTCGCCAAATAT -> ATCGTAGTCGCCAAATATG
CATCGCGGCAACTCTTGGG -> ATCGCGGCAACTCTTGGGT
CGCTTGCCCTCCCTCATCA -> GCTTGCCCTCCCTCATCAT
AAGAACGACTCAAGCGTAT -> AGAACGACTCAAGCGTATT
GCTACATAAGCTTCGCCGA -> CTACATAAGCTTCGCCGAC
AATAGCGTTGAGTTACAGC -> ATAGCGTTGAGTTACAGCC
CTACCCCAAATATTCAGGA -> TACCCCAAATATTCAGGAA
CACATTGCACGTCTCGGCA -> ACATTGCACGTCTCGGCAC
GTAGCAACTGCGGCATTAG -> TAGCAACTGCGGCATTAGA
ACTTAGTTCCTGGAACAAG -> CTTAGTTCCTGGAACAAGG
CGGCGGACAAGTATCCATC -> GGCGGACAAGTATCCATCG
GACCTCCGTTCAGACCGAG -> ACCTCCGTTCAGACCGAGT
ATCAGGGTACAGTTTCTAT -> TCAGGGTACAGTTTCTATA
CGACCATTAATCCCACGAG -> GACCATTAATCCCACGAGA
AAGATCACGCACCTGCACT -> AGATCACGCACCTGCACTG
ATTTGTATATAGGTTTGAC -> TTTGTATATAGGTTTGACG
ATATAGGTTTGACGGTAGC -> TATAGGTTTGACGGTAGCT
TCAGGATTTAGAGCGGTTC -> CAGGATTTAGAGCGGTTCA
CTACGTCGATGATGTAAGC -> TACGTCGATGATGTAAGCC
GAGTTCACTATGCTACATA -> AGTTCACTATGCTACATAA
TGCCGGTGCTCCTTTTAGC -> GCCGGTGCTCCTTTTAGCT
GCTGTCGCTCACCGTGCCG -> CTGTCGCTCACCGTGCCGT
TTGCCTTTCCAAATGAGGT -> TGCCTTTCCAAATGAGGTC
AGGAATGAGGCATTCTATG -> GGAATGAGGCATTCTATGC
TCCGCCTCTGCCAAGGAGA -> CCGCCTCTGCCAAGGAGAC
TACGTTATACGGTGGTGTC -> ACGTTATACGGTGGTGTCC
GGCGGACAAGTATCCATCG -> GCGGACAAGTATCCATCGG
CAGCCAATTGCTAACGGGA -> AGCCAATTGCTAACGGGAC
GCACCAACCATAGGAAGGA -> CACCAACCATAGGAAGGAC
TTGTTTCGCCGATCGATGG -> TGTTTCGCCGATCGATGGC
CGCACCAACCATAGGAAGG -> GCACCAACCATAGGAAGGA
GCGGACAAGTATCCATCGG -> CGGACAAGTATCCATCGGC
CCTGGTACCTAGTTGTCCG -> CTGGTACCTAGTTGTCCGC
GAGGGGAGTTCAGGATTTA -> AGGGGAGTTCAGGATTTAG
GCAGTCCACAGGGAGGAGG -> CAGTCCACAGGGAGGAGGG
TACGATAGAGGATCACAGT -> ACGATAGAGGATCACAGTG
TTAGCGTAGCAACTGCGGC -> TAGCGTAGCAACTGCGGCA
AGTGAAGGCGAAGAAGGAG -> GTGAAGGCGAAGAAGGAGA
TTACGTTATACGGTGGTGT -> TACGTTATACGGTGGTGTC
CCTCATCATCCGAATATTG -> CTCATCATCCGAATATTGC
AATTGCTAACGGGACCCCG -> ATTGCTAACGGGACCCCGT
CTTTTAGCCACTAGGCCTC -> TTTTAGCCACTAGGCCTCT
GTGGTACTCCTTACAGCGC -> TGGTACTCCTTACAGCGCA
TGAAAAGGGGACTTGACCG -> GAAAAGGGGACTTGACCGA
ATAAGAAAAGTGATAGAGT -> TAAGAAAAGTGATAGAGTA
CCTCGCGGAGCCCCGACGA -> CTCGCGGAGCCCCGACGAG
TGAAGTAGGGCTCCACCAC -> GAAGTAGGGCTCCACCACA
CTGACTGGATAAGATCACG -> TGACTGGATAAGATCACGC
TAGGCTATGATTGAGCGTT -> AGGCTATGATTGAGCGTTT
GTAAAAGAGTAGCTCATTT -> TAAAAGAGTAGCTCATTTA
TTTAGCCACTAGGCCTCTT -> TTAGCCACTAGGCCTCTTG
GCCTGTCTCTGTCCCTTCA -> CCTGTCTCTGTCCCTTCAC
ATCCAGGGAGGACCTACTC -> TCCAGGGAGGACCTACTCA
TGTTAGACGACCATTAATC -> GTTAGACGACCATTAATCC
GATTTAGATGACGGTGCCC -> ATTTAGATGACGGTGCCCT
TATTGAAGTAGGGCTCCAC -> ATTGAAGTAGGGCTCCACC
CAGTTTCTATAATACCATT -> AGTTTCTATAATACCATTG
GGATCTCAAGACTTGCTAC -> GATCTCAAGACTTGCTACT
ATCTCCATAAGAAAAGTGA -> TCTCCATAAGAAAAGTGAT
CTGCCGGTGCTCCTTTTAG -> TGCCGGTGCTCCTTTTAGC
TGCTACACTCTCGGGTTCT -> GCTACACTCTCGGGTTCTA
TTTCCGGTCGAGACCAAAC -> TTCCGGTCGAGACCAAACT
CTCAGGGCTTGTTAGTTGC -> TCAGGGCTTGTTAGTTGCT
ACTGCAACCGGCGTCATCG -> CTGCAACCGGCGTCATCGT
GTAAGCCGTCGTTCTGCCG -> TAAGCCGTCGTTCTGCCGT
CATTGCACGTCTCGGCACG -> ATTGCACGTCTCGGCACGC
ATCGGCTGCTATTTGTGCC -> TCGGCTGCTATTTGTGCCC
GTCCCGGTGGTGAGAAATA -> TCCCGGTGGTGAGAAATAC
AAAGACTCGGTCTGGACGT -> AAGACTCGGTCTGGACGTT
ATGGTATAGATGCCGTTAA -> TGGTATAGATGCCGTTAAT
GAGCGTTTGCCAATAAAAT -> AGCGTTTGCCAATAAAATT
GGTCTGGACGTTGCCTTTC -> GTCTGGACGTTGCCTTTCC
CGTTGTATGTCATTGACCT -> GTTGTATGTCATTGACCTC
TTCAGACCGAGTAACATGG -> TCAGACCGAGTAACATGGG
CCATAAGAAAAGTGATAGA -> CATAAGAAAAGTGATAGAG
ATGGTCATCCAGGGAGGAC -> TGGTCATCCAGGGAGGACC
CCGTGCCGTATCATGGGAC -> CGTGCCGTATCATGGGACC
TACGTTACGTTATACGGTG -> ACGTTACGTTATACGGTGG
TAAAGACTCGGTCTGGACG -> AAAGACTCGGTCTGGACGT
GCGCTACTCGACAACCGAC -> CGCTACTCGACAACCGACG
TAGAGACTTAGAAGACGCT -> AGAGACTTAGAAGACGCTA
TGGGCGAGAGTTTCTCCTG -> GGGCGAGAGTTTCTCCTGT
AATGAGGCATTCTATGCCC -> ATGAGGCATTCTATGCCCG
AATATTGCTATGACGCCCT -> ATATTGCTATGACGCCCTC
CGGCGCGGACTATTAACAG -> GGCGCGGACTATTAACAGG
ACCGCGCACAGAACATGAA -> CCGCGCACAGAACATGAAA
CTACTATGAGAGCAGTCTT -> TACTATGAGAGCAGTCTTA
CTTGGGCCTTGACGCTGTC -> TTGGGCCTTGACGCTGTCC
AACTGACGAGTTACGCTAG -> ACTGACGAGTTACGCTAGT
ATCATCCGAATATTGCTAT -> TCATCCGAATATTGCTATG
AATGAGGCATTCCGCCTCT -> ATGAGGCATTCCGCCTCTG
ACTGTAAAGACTCGGTCTG -> CTGTAAAGACTCGGTCTGG
TCATAAAACCTCCAGACGG -> CATAAAACCTCCAGACGGG
CCTACGATAGAGGATCACA -> CTACGATAGAGGATCACAG
CATAAGAAAAGTGATAGAG -> ATAAGAAAAGTGATAGAGT
GTCATTGACCTCCGTTCAG -> TCATTGACCTCCGTTCAGA
TAGCGTAGCAACTGCGGCA -> AGCGTAGCAACTGCGGCAT
ATGACGGTGCCCTACGTCG -> TGACGGTGCCCTACGTCGA
TGAGAGCAGTCTTACTTGT -> GAGAGCAGTCTTACTTGTT
ACGGTGGTGTCCTGGGGTA -> CGGTGGTGTCCTGGGGTAG
ATAGCTTCATAAAACCTCC -> TAGCTTCATAAAACCTCCA
GACCGGTATCCCTACGATA -> ACCGGTATCCCTACGATAG
CCAAACTGTGGGACTTGGG -> CAAACTGTGGGACTTGGGC
CATTCTATGCCCGCAAAGG -> ATTCTATGCCCGCAAAGGA
CGATAGAGGATCACAGTGG -> GATAGAGGATCACAGTGGC
ACCTAGTTGTCCGCTTTTA -> CCTAGTTGTCCGCTTTTAG
TCTGTTACTTCAGGAATGA -> CTGTTACTTCAGGAATGAG
TTATCAGATACTCCTTCCC -> TATCAGATACTCCTTCCCG
CACATTAAGGACGGCGCAA -> ACATTAAGGACGGCGCAAC
ACTTTTCCCCGTGTGTTGT -> CTTTTCCCCGTGTGTTGTC
CGGTTCACCATCGCGGCAA -> GGTTCACCATCGCGGCAAC
GTTACAGCCCTCCCCCGTC -> TTACAGCCCTCCCCCGTCT
CGACACCCGTAGTCGCGGG -> GACACCCGTAGTCGCGGGA
TTCACCAGCCTGTCTCTGT -> TCACCAGCCTGTCTCTGTC
CTGCCAAGGAGACCCATAG -> TGCCAAGGAGACCCATAGC
GTTGAGTTACAGCCAATTG -> TTGAGTTACAGCCAATTGC
AGTGTTAGACGACCATTAA -> GTGTTAGACGACCATTAAT
CTTGCTACTATGAGAGCAG -> TTGCTACTATGAGAGCAGT
ATGTCATTGACCTCCGTTC -> TGTCATTGACCTCCGTTCA
GCTAGTTGCCCACATTGCA -> CTAGTTGCCCACATTGCAC
TGATTGAGCGTTTGCCAAT -> GATTGAGCGTTTGCCAATA
GTTATTAAGGAGACCCATA -> TTATTAAGGAGACCCATAG
ATACTTAGTTCCTGGAACA -> TACTTAGTTCCTGGAACAA
CGGGGCTCCGGAACGCGGT -> GGGGCTCCGGAACGCGGTG
CACTAAGGAGACCCATAGC -> ACTAAGGAGACCCATAGCT
TCAGGAATGAGGCATTCAC -> CAGGAATGAGGCATTCACG
AGCTAACTGACGAGTTACG -> GCTAACTGACGAGTTACGC
GAACATGAAAAGGGGACTT -> AACATGAAAAGGGGACTTG
GCACTAACTGTAAAGACTC -> CACTAACTGTAAAGACTCG
CTCATTTACTTTCGTTACG -> TCATTTACTTTCGTTACGG
ACCAAACTGTGGGACTTGG -> CCAAACTGTGGGACTTGGG
GCCAAGGAGACCCATAGCT -> CCAAGGAGACCCATAGCTT
GTATGTGGTACTCCTTACA -> TATGTGGTACTCCTTACAG
CAAATATTCAGGAATGAGG -> AAATATTCAGGAATGAGGC
TCCAAATGAGGTCCGCGTA -> CCAAATGAGGTCCGCGTAG
CGTAGTCGCCAAATATGGT -> GTAGTCGCCAAATATGGTA
TACTCCTTACAGCGCAAGC -> ACTCCTTACAGCGCAAGCC
GCTACTCGACAACCGACGC -> CTACTCGACAACCGACGCT
GATCCTGAGCCCACTCCGC -> ATCCTGAGCCCACTCCGCT
ATTGCTATGACGCCCTCAA -> TTGCTATGACGCCCTCAAT
CGTCTTTAGGACACCCGCA -> GTCTTTAGGACACCCGCAC
AGACTTCACCAGCCTGTCT -> GACTTCACCAGCCTGTCTC
GCACTGCAACCGGCGTCAT -> CACTGCAACCGGCGTCATC
GAAGGACCGCGCACAGAAC -> AAGGACCGCGCACAGAACA
TTGTTAGTTGCTACACTCT -> TGTTAGTTGCTACACTCTC
ATTAGGTATTTCAGGAATG -> TTAGGTATTTCAGGAATGA
CGCTGAGGAACCACTACCC -> GCTGAGGAACCACTACCCC
CAAGCGTATTTTTCATTTG -> AAGCGTATTTTTCATTTGT
GCGCAGTCCACAGGGAGGA -> CGCAGTCCACAGGGAGGAG
TAAGAGTCTGATTTAGATG -> AAGAGTCTGATTTAGATGA
ATAAGCTTCGCCGACGAGG -> TAAGCTTCGCCGACGAGGC
CGCGCTACTCGACAACCGA -> GCGCTACTCGACAACCGAC
CCCATAGCTTCATTGTGCG -> CCATAGCTTCATTGTGCGG
GCTAACGGGACCCCGTCCT -> CTAACGGGACCCCGTCCTT
ATTTCAGGAATGAGGCATT -> TTTCAGGAATGAGGCATTC
GCAACCGGCGTCATCGTAG -> CAACCGGCGTCATCGTAGT
TAGAGGATCACAGTGGCCG -> AGAGGATCACAGTGGCCGA
CTGGACGTTGCCTTTCCAA -> TGGACGTTGCCTTTCCAAA
TGGATACTTAGTTCCTGGA -> GGATACTTAGTTCCTGGAA
TGTGTTGTCCGGCGCGGAC -> GTGTTGTCCGGCGCGGACT
ATCATGGGACCGGTATCCC -> TCATGGGACCGGTATCCCT
TCGACAACCGACGCTAATG -> CGACAACCGACGCTAATGC
AGACCAAGATTTTTCCCTC -> GACCAAGATTTTTCCCTCA
CAGGAATGAGGCATTCGTA -> AGGAATGAGGCATTCGTAC
TTGAATAGCGTTGAGTTAC -> TGAATAGCGTTGAGTTACA
GGTCGTTTCCGGTCGAGAC -> GTCGTTTCCGGTCGAGACC
GCGTTGTATGTCATTGACC -> CGTTGTATGTCATTGACCT
GGTGCCAGCTAACTGACGA -> GTGCCAGCTAACTGACGAG
GTTCACCCTTCCGAGAGTT -> TTCACCCTTCCGAGAGTTG
TATTCAGGAATGAGGCATT -> ATTCAGGAATGAGGCATTC
ACTTCACCAGCCTGTCTCT -> CTTCACCAGCCTGTCTCTG
AGCGTTTGCCAATAAAATT -> GCGTTTGCCAATAAAATTA
GCGTAGCAACTGCGGCATT -> CGTAGCAACTGCGGCATTA
CCCGTCTTTAGGACACCCG -> CCGTCTTTAGGACACCCGC
CGCGGGACTGGATTAAGAG -> GCGGGACTGGATTAAGAGT
TCCCGGTGGTGAGAAATAC -> CCCGGTGGTGAGAAATACG
CTTGTTTCGCCGATCGATG -> TTGTTTCGCCGATCGATGG
AGGAACCCAGATACGGTTC -> GGAACCCAGATACGGTTCA
TGTGCCCGCTTGCCCTCCC -> GTGCCCGCTTGCCCTCCCT
TATTTGTATATAGGTTTGA -> ATTTGTATATAGGTTTGAC
GTCTGCTGATGTATTATTA -> TCTGCTGATGTATTATTAG
TTAGGACACCCGCACCAAC -> TAGGACACCCGCACCAACC
AACATGCTTGCTGTCCGCG -> ACATGCTTGCTGTCCGCGC
CCAAATATGGTATAGATGC -> CAAATATGGTATAGATGCC
CATAAGCTTCGCCGACGAG -> ATAAGCTTCGCCGACGAGG
TGTCCTGGGGTAGGCGTCT -> GTCCTGGGGTAGGCGTCTT
TGCCCACATTGCACGTCTC -> GCCCACATTGCACGTCTCG
TTGCCCTCCCTCATCATCC -> TGCCCTCCCTCATCATCCG
TACCCCAAATATTCAGGAA -> ACCCCAAATATTCAGGAAT
GCCTCTTGCTCGTACTTGA -> CCTCTTGCTCGTACTTGAG
TCACCAGCCTGTCTCTGTC -> CACCAGCCTGTCTCTGTCC
TTGGCTCAGATACGAGCGC -> TGGCTCAGATACGAGCGCC
GCACTGCCCTAAACCTGGT -> CACTGCCCTAAACCTGGTA
ACGGCGATGCGAAGTTATC -> CGGCGATGCGAAGTTATCA
GAATGAGGCATTCACGAGT -> AATGAGGCATTCACGAGTT
TGAGCCCACTCCGCTGAGG -> GAGCCCACTCCGCTGAGGA
GTCTTGACTCTCATCAGGG -> TCTTGACTCTCATCAGGGT
GAGGATCACAGTGGCCGAG -> AGGATCACAGTGGCCGAGG
CGCCTCGCGGAGCCCCGAC -> GCCTCGCGGAGCCCCGACG
GGGCTTGTTAGTTGCTACA -> GGCTTGTTAGTTGCTACAC
TTACGCTAGTAAGGAGCTT -> TACGCTAGTAAGGAGCTTC
TTACTTCATGGATCTCCAT -> TACTTCATGGATCTCCATA
GCGAAGAAGGAGACTTCAC -> CGAAGAAGGAGACTTCACC
CCGAGGACTCCACAGGTGC -> CGAGGACTCCACAGGTGCC
TACGGTTCATACCTTTACT -> ACGGTTCATACCTTTACTC
GGCTCCGGAACGCGGTGAG -> GCTCCGGAACGCGGTGAGT
CATACCTTTACTCGGTTCA -> ATACCTTTACTCGGTTCAC
CCGACGAGGCTGCGTTGTA -> CGACGAGGCTGCGTTGTAT
CTTGCTCGTACTTGAGCGC -> TTGCTCGTACTTGAGCGCG
TCATCCGAATATTGCTATG -> CATCCGAATATTGCTATGA
ATAAGATCACGCACCTGCA -> TAAGATCACGCACCTGCAC
CGCACCTGCACTGCAACCG -> GCACCTGCACTGCAACCGG
GACCGAGTAACATGGGGAA -> ACCGAGTAACATGGGGAAC
TCACTGCCGGTGCTCCTTT -> CACTGCCGGTGCTCCTTTT
GTGCCCTACGTCGATGATG -> TGCCCTACGTCGATGATGT
TCGGTCTGGACGTTGCCTT -> CGGTCTGGACGTTGCCTTT
CGACTGGTGCACTAACTGT -> GACTGGTGCACTAACTGTA
GAGTCTTTGAATAGCGTTG -> AGTCTTTGAATAGCGTTGA
TGACGCCTCGCGGAGCCCC -> GACGCCTCGCGGAGCCCCG
CCCCGTGTGTTGTCCGGCG -> CCCGTGTGTTGTCCGGCGC
TATGTGGTACTCCTTACAG -> ATGTGGTACTCCTTACAGC
CGGACCCCGCGATTTACTT -> GGACCCCGCGATTTACTTC
CTTAGAAGACGCTAGCTGC -> TTAGAAGACGCTAGCTGCA
GTGTTAGACGACCATTAAT -> TGTTAGACGACCATTAATC
TGGTGAGAAATACGTTACG -> GGTGAGAAATACGTTACGT
TTAGTTCCTGGAACAAGGG -> TAGTTCCTGGAACAAGGGG
AGCTGCAACGACACCCGTA -> GCTGCAACGACACCCGTAG
CTGCGTTGTATGTCATTGA -> TGCGTTGTATGTCATTGAC
TTATTTTGGCAGGAACCCA -> TATTTTGGCAGGAACCCAG
CCCCGTCCTTATTTTGGCA -> CCCGTCCTTATTTTGGCAG
ACCATTAATCCCACGAGAT -> CCATTAATCCCACGAGATC
CAGGGCTTGTTAGTTGCTA -> AGGGCTTGTTAGTTGCTAC
GCCCTCCCCCGTCTTTAGG -> CCCTCCCCCGTCTTTAGGA
GGCATTCACGAGTTATTAA -> GCATTCACGAGTTATTAAG
CCTCCAGACGGGGCTCCGG -> CTCCAGACGGGGCTCCGGA
ACGACCATTAATCCCACGA -> CGACCATTAATCCCACGAG
TGACTCTGCACTGCCCTAA -> GACTCTGCACTGCCCTAAA
CTACACTCTCGGGTTCTAA -> TACACTCTCGGGTTCTAAG
AATTACTCTGACTTAGTAT -> ATTACTCTGACTTAGTATG
CCGCCTCTGCCAAGGAGAC -> CGCCTCTGCCAAGGAGACC
CTGCAACCGGCGTCATCGT -> TGCAACCGGCGTCATCGTA
TTCCAAATGAGGTCCGCGT -> TCCAAATGAGGTCCGCGTA
ATCCATCGGCTGCTATTTG -> TCCATCGGCTGCTATTTGT
ACGAGATCCTGAGCCCACT -> CGAGATCCTGAGCCCACTC
TGCAACCGGCGTCATCGTA -> GCAACCGGCGTCATCGTAG
GTCCCTTCACTGCCGGTGC -> TCCCTTCACTGCCGGTGCT
GAGACTTCACCAGCCTGTC -> AGACTTCACCAGCCTGTCT
TTGCACGTCTCGGCACGCA -> TGCACGTCTCGGCACGCAC
TCCAACGGACCCCGCGATT -> CCAACGGACCCCGCGATTT
TATATTGAAGTAGGGCTCC -> ATATTGAAGTAGGGCTCCA
AGGACAGCGTTGGCTCAGA -> GGACAGCGTTGGCTCAGAT
TTGAGCGCGTCCAACGGAC -> TGAGCGCGTCCAACGGACC
TTGTCCGCTTTTAGCCACT -> TGTCCGCTTTTAGCCACTA
TTCGTACGGCACTAAGGAG -> TCGTACGGCACTAAGGAGA
GGCTCAGATACGAGCGCCT -> GCTCAGATACGAGCGCCTG
TTGTATATAGGTTTGACGG -> TGTATATAGGTTTGACGGT
ATCGATGGCCAATTACGTG -> TCGATGGCCAATTACGTGG
TTTATGGATCTCAAGACTT -> TTATGGATCTCAAGACTTG
GTCCGGGAAACTGACTGGA -> TCCGGGAAACTGACTGGAT
GAGGACCTACTCACTTTTC -> AGGACCTACTCACTTTTCC
TAGCGTTAGCTAGTTGCCC -> AGCGTTAGCTAGTTGCCCA
CGTACTTGAGCGCGTCCAA -> GTACTTGAGCGCGTCCAAC
CGATGCGAAGTTATCAGAT -> GATGCGAAGTTATCAGATA
TTGGCAGGAACCCAGATAC -> TGGCAGGAACCCAGATACG
ATAGCTTCATTTCGAAAAG -> TAGCTTCATTTCGAAAAGA
CAACCATAGGAAGGACCGC -> AACCATAGGAAGGACCGCG
AGGGTACAGTTTCTATAAT -> GGGTACAGTTTCTATAATA
AATCCCACGAGATCCTGAG -> ATCCCACGAGATCCTGAGC
GATAGAGGATCACAGTGGC -> ATAGAGGATCACAGTGGCC
CCGGTGGTGAGAAATACGT -> CGGTGGTGAGAAATACGTT
TTGACGGTAGCTCAGGGCT -> TGACGGTAGCTCAGGGCTT
GTCCGCGTAGGTTTATGGA -> TCCGCGTAGGTTTATGGAT
GGGAGGAGGGGAGTTCAGG -> GGAGGAGGGGAGTTCAGGA
ACCCCGTCCTTATTTTGGC -> CCCCGTCCTTATTTTGGCA
TAAGGAGCTTCGAACTGCT -> AAGGAGCTTCGAACTGCTC
TGTCTATATTGAAGTAGGG -> GTCTATATTGAAGTAGGGC
ATCTCAAGACTTGCTACTA -> TCTCAAGACTTGCTACTAT
AGACTTGCTACTATGAGAG -> GACTTGCTACTATGAGAGC
TTCCCGGGGTCCCGGTGGT -> TCCCGGGGTCCCGGTGGTG
ATTTGTTGGATTAAAACCG -> TTTGTTGGATTAAAACCGT
CGTATTTTTCATTTGTTGG -> GTATTTTTCATTTGTTGGA
AGGATCACAGTGGCCGAGG -> GGATCACAGTGGCCGAGGA
CGTTCTGCCGTGGGCGAGA -> GTTCTGCCGTGGGCGAGAG
GTTGTCCGGCGCGGACTAT -> TTGTCCGGCGCGGACTATT
GTTCAGGATTTAGAGCGGT -> TTCAGGATTTAGAGCGGTT
CCACTAGGCCTCTTGCTCG -> CACTAGGCCTCTTGCTCGT
CTTGACGCTGTCCGGGAAA -> TTGACGCTGTCCGGGAAAC
TGGATTAAGAGTCTGATTT -> GGATTAAGAGTCTGATTTA
TGTCATTGACCTCCGTTCA -> GTCATTGACCTCCGTTCAG
GGACGGCGCAACAGACCAA -> GACGGCGCAACAGACCAAG
AGTGGCCGAGGACTCCACA -> GTGGCCGAGGACTCCACAG
TCGGCACGCACATTAAGGA -> CGGCACGCACATTAAGGAC
CAACGACACCCGTAGTCGC -> AACGACACCCGTAGTCGCG
CTCTGTCCCTTCACTGCCG -> TCTGTCCCTTCACTGCCGG
CCAATTACGTGGAGGCTGT -> CAATTACGTGGAGGCTGTC
AATGAGGTCCGCGTAGGTT -> ATGAGGTCCGCGTAGGTTT
CCATCGCGGCAACTCTTGG -> CATCGCGGCAACTCTTGGG
TTTGAATAGCGTTGAGTTA -> TTGAATAGCGTTGAGTTAC
TCGCCGACGAGGCTGCGTT -> CGCCGACGAGGCTGCGTTG
ACGACGCTATGTTAGGCTA -> CGACGCTATGTTAGGCTAT
AGTTACGCTAGTAAGGAGC -> GTTACGCTAGTAAGGAGCT
CCATAGCTTCATAAAACCT -> CATAGCTTCATAAAACCTC
GGGACTGGATTAAGAGTCT -> GGACTGGATTAAGAGTCTG
GACGCCTCGCGGAGCCCCG -> ACGCCTCGCGGAGCCCCGA
CGCGGAGCCCCGACGAGTG -> GCGGAGCCCCGACGAGTGT
AAAAGGGGACTTGACCGAC -> AAAGGGGACTTGACCGACT
TCGCGGCAACTCTTGGGTT -> CGCGGCAACTCTTGGGTTC
TTTCATTTGTTGGATTAAA -> TTCATTTGTTGGATTAAAA
ATACTCCTTCCCGGGGTCC -> TACTCCTTCCCGGGGTCCC
GCGGGACTGGATTAAGAGT -> CGGGACTGGATTAAGAGTC
TCCGAATATTGCTATGACG -> CCGAATATTGCTATGACGC
GGCAGGAACCCAGATACGG -> GCAGGAACCCAGATACGGT
CCTGAGCCCACTCCGCTGA -> CTGAGCCCACTCCGCTGAG
AAGGACGGCGCAACAGACC -> AGGACGGCGCAACAGACCA
TAACGGGACCCCGTCCTTA -> AACGGGACCCCGTCCTTAT
GTAGTCGCGGGACTGGATT -> TAGTCGCGGGACTGGATTA
GTTCCTGGAACAAGGGGAT -> TTCCTGGAACAAGGGGATC
TAGGAAGGACCGCGCACAG -> AGGAAGGACCGCGCACAGA
CCTGACGCCTCGCGGAGCC -> CTGACGCCTCGCGGAGCCC
TAAGAAAAGTGATAGAGTA -> AAGAAAAGTGATAGAGTAG
ACGTGGAGGCTGTCGCTCA -> CGTGGAGGCTGTCGCTCAC
CACAGGGAGGAGGGGAGTT -> ACAGGGAGGAGGGGAGTTC
TAATACCATTGGATACTTA -> AATACCATTGGATACTTAG
GGGGTAGGCGTCTTGACTC -> GGGTAGGCGTCTTGACTCT
AAGGCGAAGAAGGAGACTT -> AGGCGAAGAAGGAGACTTC
GGATCACAGTGGCCGAGGA -> GATCACAGTGGCCGAGGAC
GACTCTGCACTGCCCTAAA -> ACTCTGCACTGCCCTAAAC
TACTCGACAACCGACGCTA -> ACTCGACAACCGACGCTAA
AAGAAGGAGACTTCACCAG -> AGAAGGAGACTTCACCAGC
CTTTCGTTACGGTCGTTTC -> TTTCGTTACGGTCGTTTCC
GTTACGCTAGTAAGGAGCT -> TTACGCTAGTAAGGAGCTT
GGTGCACTAACTGTAAAGA -> GTGCACTAACTGTAAAGAC
TCTCCATAAGAAAAGTGAT -> CTCCATAAGAAAAGTGATA
GGTGGTGAGAAATACGTTA -> GTGGTGAGAAATACGTTAC
GTATTTTTCATTTGTTGGA -> TATTTTTCATTTGTTGGAT
GGAGCCCCGACGAGTGTTA -> GAGCCCCGACGAGTGTTAG
CGGTTCATACCTTTACTCG -> GGTTCATACCTTTACTCGG
TTGAGCGTTTGCCAATAAA -> TGAGCGTTTGCCAATAAAA
CGGTATCCCTACGATAGAG -> GGTATCCCTACGATAGAGG
GTTCACCATCGCGGCAACT -> TTCACCATCGCGGCAACTC
GTGGCCGAGGACTCCACAG -> TGGCCGAGGACTCCACAGG
CAATTCAAGTGAAGGCGAA -> AATTCAAGTGAAGGCGAAG
TACTCACTTTTCCCCGTGT -> ACTCACTTTTCCCCGTGTG
ACTCCTTACAGCGCAAGCC -> CTCCTTACAGCGCAAGCCC
GCATTCTATGCCCGCAAAG -> CATTCTATGCCCGCAAAGG
CACTCCGCTGAGGAACCAC -> ACTCCGCTGAGGAACCACT
TCAAGCGTATTTTTCATTT -> CAAGCGTATTTTTCATTTG
GCACCTGCACTGCAACCGG -> CACCTGCACTGCAACCGGC
ACGGTGCCCTACGTCGATG -> CGGTGCCCTACGTCGATGA
AGGCCTCTTGCTCGTACTT -> GGCCTCTTGCTCGTACTTG
CGGTTCACCCTTCCGAGAG -> GGTTCACCCTTCCGAGAGT
GGCATTCCGCCTCTGCCAA -> GCATTCCGCCTCTGCCAAG
TCCCTCATCATCCGAATAT -> CCCTCATCATCCGAATATT
TCATAAGACGGCGATGCGA -> CATAAGACGGCGATGCGAA
TATTGCTATGACGCCCTCA -> ATTGCTATGACGCCCTCAA
CTGCTATTTGTGCCCGCTT -> TGCTATTTGTGCCCGCTTG
GTCATCGTAGTCGCCAAAT -> TCATCGTAGTCGCCAAATA
ATAAAATTACTCTGACTTA -> TAAAATTACTCTGACTTAG
GGCATTCTATGCCCGCAAA -> GCATTCTATGCCCGCAAAG
AGACCCATAGCTTCATAAA -> GACCCATAGCTTCATAAAA
ACATGGTCATCCAGGGAGG -> CATGGTCATCCAGGGAGGA
GGCGATGCGAAGTTATCAG -> GCGATGCGAAGTTATCAGA
GTACTTGAGCGCGTCCAAC -> TACTTGAGCGCGTCCAACG
GGGTTCTAAGCTTAGCGTA -> GGTTCTAAGCTTAGCGTAG
ACCTACTCACTTTTCCCCG -> CCTACTCACTTTTCCCCGT
TAGACGACCATTAATCCCA -> AGACGACCATTAATCCCAC
AGAGTTTCTCCTGTTAGCG -> GAGTTTCTCCTGTTAGCGT
GCCGGTTACAGCCCTCCCC -> CCGGTTACAGCCCTCCCCC
AGAGTCTGATTTAGATGAC -> GAGTCTGATTTAGATGACG
CATGGGGAACATGCTTGCT -> ATGGGGAACATGCTTGCTG
TTACTCGGTTCACCCTTCC -> TACTCGGTTCACCCTTCCG
GCACTAAGGAGACCCATAG -> CACTAAGGAGACCCATAGC
GCCCTAAACCTGGTACCTA -> CCCTAAACCTGGTACCTAG
ACTAGGCCTCTTGCTCGTA -> CTAGGCCTCTTGCTCGTAC
TGCACTGCCCTAAACCTGG -> GCACTGCCCTAAACCTGGT
TTTGCCAATAAAATTACTC -> TTGCCAATAAAATTACTCT
TAGGTTTATGGATCTCAAG -> AGGTTTATGGATCTCAAGA
CGATTTACTTCATGGATCT -> GATTTACTTCATGGATCTC
CGCAAAGGAGACCCATAGC -> GCAAAGGAGACCCATAGCT
GCTATTTGTGCCCGCTTGC -> CTATTTGTGCCCGCTTGCC
TCTCCTGTTAGCGTTAGCT -> CTCCTGTTAGCGTTAGCTA
ATACCTTTACTCGGTTCAC -> TACCTTTACTCGGTTCACC
CGTTGCCTTTCCAAATGAG -> GTTGCCTTTCCAAATGAGG
CCGTGGGCGAGAGTTTCTC -> CGTGGGCGAGAGTTTCTCC
AGCGCAAGCCCGGCAATTC -> GCGCAAGCCCGGCAATTCA
TCCATAAGAAAAGTGATAG -> CCATAAGAAAAGTGATAGA
CTGATGTATTATTAGGTAT -> TGATGTATTATTAGGTATT
TCATGGATCTCCATAAGAA -> CATGGATCTCCATAAGAAA
GGCCTCTTGCTCGTACTTG -> GCCTCTTGCTCGTACTTGA
CAAGATTTTTCCCTCATTG -> AAGATTTTTCCCTCATTGT
GGAACGCGGTGAGTTCACT -> GAACGCGGTGAGTTCACTA
CTAGTTGCCCACATTGCAC -> TAGTTGCCCACATTGCACG
ACCGTGCCGTATCATGGGA -> CCGTGCCGTATCATGGGAC
CACATGGTCATCCAGGGAG -> ACATGGTCATCCAGGGAGG
CATCGGCTGCTATTTGTGC -> ATCGGCTGCTATTTGTGCC
GACGACCATTAATCCCACG -> ACGACCATTAATCCCACGA
GCACAGAACATGAAAAGGG -> CACAGAACATGAAAAGGGG
CCTTCACTGCCGGTGCTCC -> CTTCACTGCCGGTGCTCCT
TGCTGATGTATTATTAGGT -> GCTGATGTATTATTAGGTA
GTTTGACGGTAGCTCAGGG -> TTTGACGGTAGCTCAGGGC
GCTGCAACGACACCCGTAG -> CTGCAACGACACCCGTAGT
ACCCGTAGTCGCGGGACTG -> CCCGTAGTCGCGGGACTGG
TAAAACCGTGCACCAGACG -> AAAACCGTGCACCAGACGA
GTTACAGCCAATTGCTAAC -> TTACAGCCAATTGCTAACG
ACCGAGTAACATGGGGAAC -> CCGAGTAACATGGGGAACA
GGAGGACCTACTCACTTTT -> GAGGACCTACTCACTTTTC
TCATTTCGAAAAGAACGAC -> CATTTCGAAAAGAACGACT
TACATAAGCTTCGCCGACG -> ACATAAGCTTCGCCGACGA
TGCTATTTGTATATAGGTT -> GCTATTTGTATATAGGTTT
GTTGTCCGCTTTTAGCCAC -> TTGTCCGCTTTTAGCCACT
TCCAGGGAGGACCTACTCA -> CCAGGGAGGACCTACTCAC
CCCGACGAGTGTTAGACGA -> CCGACGAGTGTTAGACGAC
GAAGTTATCAGATACTCCT -> AAGTTATCAGATACTCCTT
CCTACTCACTTTTCCCCGT -> CTACTCACTTTTCCCCGTG
GCGGCAACTCTTGGGTTCA -> CGGCAACTCTTGGGTTCAG
AGATACTCCTTCCCGGGGT -> GATACTCCTTCCCGGGGTC
CTTCGCCGACGAGGCTGCG -> TTCGCCGACGAGGCTGCGT
CCGTGCACCAGACGACGCT -> CGTGCACCAGACGACGCTA
TGTAAGCCGTCGTTCTGCC -> GTAAGCCGTCGTTCTGCCG
CCACCACATGGTCATCCAG -> CACCACATGGTCATCCAGG
TGTGCGGTGACTCTGCACT -> GTGCGGTGACTCTGCACTG
GACACCCGCACCAACCATA -> ACACCCGCACCAACCATAG
GAGGCTGTCGCTCACCGTG -> AGGCTGTCGCTCACCGTGC
GATACGAGCGCCTGACGCC -> ATACGAGCGCCTGACGCCT
AGTTGCTACACTCTCGGGT -> GTTGCTACACTCTCGGGTT
AGCGTATTTTTCATTTGTT -> GCGTATTTTTCATTTGTTG
TCCCTACGATAGAGGATCA -> CCCTACGATAGAGGATCAC
TAGTCGCGGGACTGGATTA -> AGTCGCGGGACTGGATTAA
TGGAACAAGGGGATCGCGG -> GGAACAAGGGGATCGCGGC
AAAGGAGACCCATAGCTTC -> AAGGAGACCCATAGCTTCA
ACCGTGCACCAGACGACGC -> CCGTGCACCAGACGACGCT
GAGATCCTGAGCCCACTCC -> AGATCCTGAGCCCACTCCG
GCGAGAGTTTCTCCTGTTA -> CGAGAGTTTCTCCTGTTAG
CCATAGCTTCATTTCGAAA -> CATAGCTTCATTTCGAAAA
GCTTGTTAGTTGCTACACT -> CTTGTTAGTTGCTACACTC
TTGCTACTATGAGAGCAGT -> TGCTACTATGAGAGCAGTC
CTCCTTACAGCGCAAGCCC -> TCCTTACAGCGCAAGCCCG
CTACGATAGAGGATCACAG -> TACGATAGAGGATCACAGT
CGCCTCTGCCAAGGAGACC -> GCCTCTGCCAAGGAGACCC
TACGCTAGTAAGGAGCTTC -> ACGCTAGTAAGGAGCTTCG
GACGCTATGTTAGGCTATG -> ACGCTATGTTAGGCTATGA
TCGCGGGACTGGATTAAGA -> CGCGGGACTGGATTAAGAG
CTAATGCTATTTGTATATA -> TAATGCTATTTGTATATAG
TGGCCAATTACGTGGAGGC -> GGCCAATTACGTGGAGGCT
CGCAGTCCACAGGGAGGAG -> GCAGTCCACAGGGAGGAGG
GCAAAGGAGACCCATAGCT -> CAAAGGAGACCCATAGCTT
CCCCGCGATTTACTTCATG -> CCCGCGATTTACTTCATGG
TGATGTAAGCCGTCGTTCT -> GATGTAAGCCGTCGTTCTG
AAATGAGGTCCGCGTAGGT -> AATGAGGTCCGCGTAGGTT
CTCCTTCCCGGGGTCCCGG -> TCCTTCCCGGGGTCCCGGT
CTTCAGGAATGAGGCATTC -> TTCAGGAATGAGGCATTCC
GCTTTTAGCCACTAGGCCT -> CTTTTAGCCACTAGGCCTC
GTCTCTGTCCCTTCACTGC -> TCTCTGTCCCTTCACTGCC
AGCTTAGCGTAGCAACTGC -> GCTTAGCGTAGCAACTGCG
ACCGACGCTAATGCTATTT -> CCGACGCTAATGCTATTTG
TCAAGGCGGTCTGCTGATG -> CAAGGCGGTCTGCTGATGT
ACCGACTGGTGCACTAACT -> CCGACTGGTGCACTAACTG
ATGCGAAGTTATCAGATAC -> TGCGAAGTTATCAGATACT
CAACAGACCAAGATTTTTC -> AACAGACCAAGATTTTTCC
CGATGATGTAAGCCGTCGT -> GATGATGTAAGCCGTCGTT
GCCAATTGCTAACGGGACC -> CCAATTGCTAACGGGACCC
GATTTAGAGCGGTTCACCA -> ATTTAGAGCGGTTCACCAT
GAACATGCTTGCTGTCCGC -> AACATGCTTGCTGTCCGCG
TGCCCGCTTGCCCTCCCTC -> GCCCGCTTGCCCTCCCTCA
ATTGCTAACGGGACCCCGT -> TTGCTAACGGGACCCCGTC
TTTAGAGCGGTTCACCATC -> TTAGAGCGGTTCACCATCG
CCCTACGATAGAGGATCAC -> CCTACGATAGAGGATCACA
TTATGGATCTCAAGACTTG -> TATGGATCTCAAGACTTGC
CATTGGATACTTAGTTCCT -> ATTGGATACTTAGTTCCTG
TGACGAGTTACGCTAGTAA -> GACGAGTTACGCTAGTAAG
GGGGATCGCGGCGGACAAG -> GGGATCGCGGCGGACAAGT
TTTCAGGAATGAGGCATTC -> TTCAGGAATGAGGCATTCT
CTATGCTACATAAGCTTCG -> TATGCTACATAAGCTTCGC
GATACTTAGTTCCTGGAAC -> ATACTTAGTTCCTGGAACA
ATGAGGCATTCACGAGTTA -> TGAGGCATTCACGAGTTAT
GAGTTCAGGATTTAGAGCG -> AGTTCAGGATTTAGAGCGG
CCTTACAGCGCAAGCCCGG -> CTTACAGCGCAAGCCCGGC
GGAATGAGGCATTCCGCCT -> GAATGAGGCATTCCGCCTC
GCCAAATATGGTATAGATG -> CCAAATATGGTATAGATGC
TGACTCTCATCAGGGTACA -> GACTCTCATCAGGGTACAG
GACGCCCTCAATGTCAAGG -> ACGCCCTCAATGTCAAGGC
TCCTTCCCGGGGTCCCGGT -> CCTTCCCGGGGTCCCGGTG
TGCGTTGTATGTCATTGAC -> GCGTTGTATGTCATTGACC
TCTATAATACCATTGGATA -> CTATAATACCATTGGATAC
GCTCTGTTACTTCAGGAAT -> CTCTGTTACTTCAGGAATG
CCTCATTGTGAGTCTTTGA -> CTCATTGTGAGTCTTTGAA
CTGCAACGACACCCGTAGT -> TGCAACGACACCCGTAGTC
CATTTACTTTCGTTACGGT -> ATTTACTTTCGTTACGGTC
CTTCATAAAACCTCCAGAC -> TTCATAAAACCTCCAGACG
TAGCGCAGTCCACAGGGAG -> AGCGCAGTCCACAGGGAGG
GAGTTGTCTATATTGAAGT -> AGTTGTCTATATTGAAGTA
GCTGTCCGCGCTACTCGAC -> CTGTCCGCGCTACTCGACA
ACAACCGACGCTAATGCTA -> CAACCGACGCTAATGCTAT
TATCCCTACGATAGAGGAT -> ATCCCTACGATAGAGGATC
TCGTTACGGTCGTTTCCGG -> CGTTACGGTCGTTTCCGGT
CGTCCAACGGACCCCGCGA -> GTCCAACGGACCCCGCGAT
ACACCCGCACCAACCATAG -> CACCCGCACCAACCATAGG
CAGACGGGGCTCCGGAACG -> AGACGGGGCTCCGGAACGC
ATACGGTTCATACCTTTAC -> TACGGTTCATACCTTTACT
GACCCATAGCTTCATTTCG -> ACCCATAGCTTCATTTCGA
ATGCTACATAAGCTTCGCC -> TGCTACATAAGCTTCGCCG
TACTTCATGGATCTCCATA -> ACTTCATGGATCTCCATAA
TCTCGGGTTCTAAGCTTAG -> CTCGGGTTCTAAGCTTAGC
GAGTTATTAAGGAGACCCA -> AGTTATTAAGGAGACCCAT
CCTGGGGTAGGCGTCTTGA -> CTGGGGTAGGCGTCTTGAC
AATATTCAGGAATGAGGCA -> ATATTCAGGAATGAGGCAT
GACGTTGCCTTTCCAAATG -> ACGTTGCCTTTCCAAATGA
GCGCAACAGACCAAGATTT -> CGCAACAGACCAAGATTTT
CCTTCCCGGGGTCCCGGTG -> CTTCCCGGGGTCCCGGTGG
AAGAGTCTGATTTAGATGA -> AGAGTCTGATTTAGATGAC
AACCGACGCTAATGCTATT -> ACCGACGCTAATGCTATTT
TGAGCGTTTGCCAATAAAA -> GAGCGTTTGCCAATAAAAT
CATAGCTTCATTTCGAAAA -> ATAGCTTCATTTCGAAAAG
TGTCCGCTTTTAGCCACTA -> GTCCGCTTTTAGCCACTAG
CTGGAACAAGGGGATCGCG -> TGGAACAAGGGGATCGCGG
ATCCTGAGCCCACTCCGCT -> TCCTGAGCCCACTCCGCTG
TACACTCTCGGGTTCTAAG -> ACACTCTCGGGTTCTAAGC
TCACCCTTCCGAGAGTTGT -> CACCCTTCCGAGAGTTGTC
TGCTATTTGTGCCCGCTTG -> GCTATTTGTGCCCGCTTGC
ATTTACTTCATGGATCTCC -> TTTACTTCATGGATCTCCA
GCCTGACGCCTCGCGGAGC -> CCTGACGCCTCGCGGAGCC
TTCACTGCCGGTGCTCCTT -> TCACTGCCGGTGCTCCTTT
ACAGGGAGGAGGGGAGTTC -> CAGGGAGGAGGGGAGTTCA
CCACGAGATCCTGAGCCCA -> CACGAGATCCTGAGCCCAC
CCCGTCCTTATTTTGGCAG -> CCGTCCTTATTTTGGCAGG
CGGAACGCGGTGAGTTCAC -> GGAACGCGGTGAGTTCACT
CTTCCCGGGGTCCCGGTGG -> TTCCCGGGGTCCCGGTGGT
GATCACAGTGGCCGAGGAC -> ATCACAGTGGCCGAGGACT
AGATGACGGTGCCCTACGT -> GATGACGGTGCCCTACGTC
TATAATACCATTGGATACT -> ATAATACCATTGGATACTT
AGACGGGGCTCCGGAACGC -> GACGGGGCTCCGGAACGCG
TACTTGTTTCGCCGATCGA -> ACTTGTTTCGCCGATCGAT
GAGCGCGTCCAACGGACCC -> AGCGCGTCCAACGGACCCC
TTACTTCAGGAATGAGGCA -> TACTTCAGGAATGAGGCAT
CCCTCAATGTCAAGGCGGT -> CCTCAATGTCAAGGCGGTC
GACTTGACCGACTGGTGCA -> ACTTGACCGACTGGTGCAC
GCTTCATTGTGCGGTGACT -> CTTCATTGTGCGGTGACTC
GCCGATCGATGGCCAATTA -> CCGATCGATGGCCAATTAC
ATGTCAAGGCGGTCTGCTG -> TGTCAAGGCGGTCTGCTGA
CATTCACGAGTTATTAAGG -> ATTCACGAGTTATTAAGGA
AAGGAGACTTCACCAGCCT -> AGGAGACTTCACCAGCCTG
ATTCACGAGTTATTAAGGA -> TTCACGAGTTATTAAGGAG
CGCTTTTAGCCACTAGGCC -> GCTTTTAGCCACTAGGCCT
CAATTACGTGGAGGCTGTC -> AATTACGTGGAGGCTGTCG
GCTATGTTAGGCTATGATT -> CTATGTTAGGCTATGATTG
TAGAGTAAAAGAGTAGCTC -> AGAGTAAAAGAGTAGCTCA
GAGACTTAGAAGACGCTAG -> AGACTTAGAAGACGCTAGC
GCTATGATTGAGCGTTTGC -> CTATGATTGAGCGTTTGCC
GCTTCATAAAACCTCCAGA -> CTTCATAAAACCTCCAGAC
TGCTCCTTTTAGCTACAAT -> GCTCCTTTTAGCTACAATT
TGAGGCATTCTATGCCCGC -> GAGGCATTCTATGCCCGCA
CTTTCCAAATGAGGTCCGC -> TTTCCAAATGAGGTCCGCG
TCCTTACAGCGCAAGCCCG -> CCTTACAGCGCAAGCCCGG
GGAGCTTCGAACTGCTCTG -> GAGCTTCGAACTGCTCTGT
GCGGCGGACAAGTATCCAT -> CGGCGGACAAGTATCCATC
ACGCCTCGCGGAGCCCCGA -> CGCCTCGCGGAGCCCCGAC
ATAGCGTTGAGTTACAGCC -> TAGCGTTGAGTTACAGCCA
ACATTGCACGTCTCGGCAC -> CATTGCACGTCTCGGCACG
TTCACGAGTTATTAAGGAG -> TCACGAGTTATTAAGGAGA
TTCGAACTGCTCTGTTACT -> TCGAACTGCTCTGTTACTT
CGCACATTAAGGACGGCGC -> GCACATTAAGGACGGCGCA
TCATTGTGCGGTGACTCTG -> CATTGTGCGGTGACTCTGC
GACTGGTGCACTAACTGTA -> ACTGGTGCACTAACTGTAA
ACAGGTGCCAGCTAACTGA -> CAGGTGCCAGCTAACTGAC
CGCAAGCCCGGCAATTCAA -> GCAAGCCCGGCAATTCAAG
CGGCAATTCAAGTGAAGGC -> GGCAATTCAAGTGAAGGCG
AGACTTAGAAGACGCTAGC -> GACTTAGAAGACGCTAGCT
GAGACCAAACTGTGGGACT -> AGACCAAACTGTGGGACTT
TTCCGCCTCTGCCAAGGAG -> TCCGCCTCTGCCAAGGAGA
TGCCCTAAACCTGGTACCT -> GCCCTAAACCTGGTACCTA
TAAGCTTAGCGTAGCAACT -> AAGCTTAGCGTAGCAACTG
AACCGGCGTCATCGTAGTC -> ACCGGCGTCATCGTAGTCG
AGGTTTATGGATCTCAAGA -> GGTTTATGGATCTCAAGAC
ATTGTGAGTCTTTGAATAG -> TTGTGAGTCTTTGAATAGC
TGCTACTATGAGAGCAGTC -> GCTACTATGAGAGCAGTCT
CAGAACATGAAAAGGGGAC -> AGAACATGAAAAGGGGACT
CTGGATAAGATCACGCACC -> TGGATAAGATCACGCACCT
GATTTACTTCATGGATCTC -> ATTTACTTCATGGATCTCC
CTAAGCTTAGCGTAGCAAC -> TAAGCTTAGCGTAGCAACT
TTTGTTGGATTAAAACCGT -> TTGTTGGATTAAAACCGTG
GCCCTCAATGTCAAGGCGG -> CCCTCAATGTCAAGGCGGT
ATTTAGATGACGGTGCCCT -> TTTAGATGACGGTGCCCTA
AAGGGGATCGCGGCGGACA -> AGGGGATCGCGGCGGACAA
ACTCGACAACCGACGCTAA -> CTCGACAACCGACGCTAAT
TAAACCTGGTACCTAGTTG -> AAACCTGGTACCTAGTTGT
CAAAGGAGACCCATAGCTT -> AAAGGAGACCCATAGCTTC
GACCCATAGCTTCATAAAA -> ACCCATAGCTTCATAAAAC
AGCGTTAGCTAGTTGCCCA -> GCGTTAGCTAGTTGCCCAC
CCATCGGCTGCTATTTGTG -> CATCGGCTGCTATTTGTGC
AGGCGAAGAAGGAGACTTC -> GGCGAAGAAGGAGACTTCA
CAGCGTTGGCTCAGATACG -> AGCGTTGGCTCAGATACGA
ATCAGATACTCCTTCCCGG -> TCAGATACTCCTTCCCGGG
TTAATAGCGCAGTCCACAG -> TAATAGCGCAGTCCACAGG
GAAGTAGGGCTCCACCACA -> AAGTAGGGCTCCACCACAT
CTTTTCCCCGTGTGTTGTC -> TTTTCCCCGTGTGTTGTCC
ATCGCGGCAACTCTTGGGT -> TCGCGGCAACTCTTGGGTT
CACCAGACGACGCTATGTT -> ACCAGACGACGCTATGTTA
GAAATACGTTACGTTATAC -> AAATACGTTACGTTATACG
CAGGAATGAGGCATTCTAT -> AGGAATGAGGCATTCTATG
AACATGGGGAACATGCTTG -> ACATGGGGAACATGCTTGC
GAATGAGGCATTCTATGCC -> AATGAGGCATTCTATGCCC
GCTTGCCCTCCCTCATCAT -> CTTGCCCTCCCTCATCATC
TGTTACTTCAGGAATGAGG -> GTTACTTCAGGAATGAGGC
CGGTCGTTTCCGGTCGAGA -> GGTCGTTTCCGGTCGAGAC
GTACAGTTTCTATAATACC -> TACAGTTTCTATAATACCA
TCAAGTGAAGGCGAAGAAG -> CAAGTGAAGGCGAAGAAGG
AGCTCATTTACTTTCGTTA -> GCTCATTTACTTTCGTTAC
ATAAAACCTCCAGACGGGG -> TAAAACCTCCAGACGGGGC
GTCCTGGGGTAGGCGTCTT -> TCCTGGGGTAGGCGTCTTG
TACAGCCCTCCCCCGTCTT -> ACAGCCCTCCCCCGTCTTT
ACCAGACGACGCTATGTTA -> CCAGACGACGCTATGTTAG
TACGTGGAGGCTGTCGCTC -> ACGTGGAGGCTGTCGCTCA
GCATTAGAGACTTAGAAGA -> CATTAGAGACTTAGAAGAC
AGCTTCATAAAACCTCCAG -> GCTTCATAAAACCTCCAGA
GTTCTGCCGTGGGCGAGAG -> TTCTGCCGTGGGCGAGAGT
CGGTCTGCTGATGTATTAT -> GGTCTGCTGATGTATTATT
AGCGCAGTCCACAGGGAGG -> GCGCAGTCCACAGGGAGGA
ATTAAGGACGGCGCAACAG -> TTAAGGACGGCGCAACAGA
CTCTGTTACTTCAGGAATG -> TCTGTTACTTCAGGAATGA
AGCTTCATTGTGCGGTGAC -> GCTTCATTGTGCGGTGACT
ATTTTTCCCTCATTGTGAG -> TTTTTCCCTCATTGTGAGT
TGCTACATAAGCTTCGCCG -> GCTACATAAGCTTCGCCGA
CTTATTTTGGCAGGAACCC -> TTATTTTGGCAGGAACCCA
CCGAGAGTTGTCTATATTG -> CGAGAGTTGTCTATATTGA
CACTAGGCCTCTTGCTCGT -> ACTAGGCCTCTTGCTCGTA
CTCCATAAGAAAAGTGATA -> TCCATAAGAAAAGTGATAG
AAAACCTCCAGACGGGGCT -> AAACCTCCAGACGGGGCTC
GTTTCTATAATACCATTGG -> TTTCTATAATACCATTGGA
GCCGACGAGGCTGCGTTGT -> CCGACGAGGCTGCGTTGTA
GTTCAGACCGAGTAACATG -> TTCAGACCGAGTAACATGG
CCACTCCGCTGAGGAACCA -> CACTCCGCTGAGGAACCAC
CTTCATTGTGCGGTGACTC -> TTCATTGTGCGGTGACTCT
GATGACGGTGCCCTACGTC -> ATGACGGTGCCCTACGTCG
TCACTTTTCCCCGTGTGTT -> CACTTTTCCCCGTGTGTTG
TGATGTATTATTAGGTATT -> GATGTATTATTAGGTATTT
ATACGTTACGTTATACGGT -> TACGTTACGTTATACGGTG
CGTTATACGGTGGTGTCCT -> GTTATACGGTGGTGTCCTG
CAGACCGAGTAACATGGGG -> AGACCGAGTAACATGGGGA
GGCTATGATTGAGCGTTTG -> GCTATGATTGAGCGTTTGC
CATCCAGGGAGGACCTACT -> ATCCAGGGAGGACCTACTC
TCTATGCCCGCAAAGGAGA -> CTATGCCCGCAAAGGAGAC
GTTGCCTTTCCAAATGAGG -> TTGCCTTTCCAAATGAGGT
CACTCTCGGGTTCTAAGCT -> ACTCTCGGGTTCTAAGCTT
AGTTACAGCCAATTGCTAA -> GTTACAGCCAATTGCTAAC
TCTTACTTGTTTCGCCGAT -> CTTACTTGTTTCGCCGATC
CATAAAACCTCCAGACGGG -> ATAAAACCTCCAGACGGGG
CTGAGGAACCACTACCCCA -> TGAGGAACCACTACCCCAA
CGGTCTGGACGTTGCCTTT -> GGTCTGGACGTTGCCTTTC
GCAAGCCCGGCAATTCAAG -> CAAGCCCGGCAATTCAAGT
CCGGGAAACTGACTGGATA -> CGGGAAACTGACTGGATAA
TCCCACGAGATCCTGAGCC -> CCCACGAGATCCTGAGCCC
CTAAGGAGACCCATAGCTT -> TAAGGAGACCCATAGCTTC
AATATGGTATAGATGCCGT -> ATATGGTATAGATGCCGTT
GGCAATTCAAGTGAAGGCG -> GCAATTCAAGTGAAGGCGA
TTCACTATGCTACATAAGC -> TCACTATGCTACATAAGCT
AGTCGCCAAATATGGTATA -> GTCGCCAAATATGGTATAG
CTCCGTTCAGACCGAGTAA -> TCCGTTCAGACCGAGTAAC
ATTGACCTCCGTTCAGACC -> TTGACCTCCGTTCAGACCG
CGAGAGTTGTCTATATTGA -> GAGAGTTGTCTATATTGAA
GAGCCCCGACGAGTGTTAG -> AGCCCCGACGAGTGTTAGA
GCCGAGGACTCCACAGGTG -> CCGAGGACTCCACAGGTGC
GTAGCTCAGGGCTTGTTAG -> TAGCTCAGGGCTTGTTAGT
AGGGGATCGCGGCGGACAA -> GGGGATCGCGGCGGACAAG
GGTACTCCTTACAGCGCAA -> GTACTCCTTACAGCGCAAG
GTCGCGGGACTGGATTAAG -> TCGCGGGACTGGATTAAGA
GCTCAGATACGAGCGCCTG -> CTCAGATACGAGCGCCTGA
AAGACGCTAGCTGCAACGA -> AGACGCTAGCTGCAACGAC
AGCCTGTCTCTGTCCCTTC -> GCCTGTCTCTGTCCCTTCA
CGGTGAGTTCACTATGCTA -> GGTGAGTTCACTATGCTAC
AGTATCCATCGGCTGCTAT -> GTATCCATCGGCTGCTATT
TTCACCATCGCGGCAACTC -> TCACCATCGCGGCAACTCT
AGGACCTACTCACTTTTCC -> GGACCTACTCACTTTTCCC
TGACCGACTGGTGCACTAA -> GACCGACTGGTGCACTAAC
CCGTCCTTATTTTGGCAGG -> CGTCCTTATTTTGGCAGGA
GGACACCCGCACCAACCAT -> GACACCCGCACCAACCATA
GCAACTGCGGCATTAGAGA -> CAACTGCGGCATTAGAGAC
AGTTGTCTATATTGAAGTA -> GTTGTCTATATTGAAGTAG
CCTCCGTTCAGACCGAGTA -> CTCCGTTCAGACCGAGTAA
AAGACTCGGTCTGGACGTT -> AGACTCGGTCTGGACGTTG
AGCGTTGAGTTACAGCCAA -> GCGTTGAGTTACAGCCAAT
GATTGAGCGTTTGCCAATA -> ATTGAGCGTTTGCCAATAA
AGATTTTTCCCTCATTGTG -> GATTTTTCCCTCATTGTGA
AGGCTGTCGCTCACCGTGC -> GGCTGTCGCTCACCGTGCC
GCGGTTCACCATCGCGGCA -> CGGTTCACCATCGCGGCAA
GTCGCTCACCGTGCCGTAT -> TCGCTCACCGTGCCGTATC
TTGCTCGTACTTGAGCGCG -> TGCTCGTACTTGAGCGCGT
TCGTACTTGAGCGCGTCCA -> CGTACTTGAGCGCGTCCAA
CAAGTATCCATCGGCTGCT -> AAGTATCCATCGGCTGCTA
CGAGAGTTTCTCCTGTTAG -> GAGAGTTTCTCCTGTTAGC
GGACCGCGCACAGAACATG -> GACCGCGCACAGAACATGA
GGCTGCGTTGTATGTCATT -> GCTGCGTTGTATGTCATTG
CTCAGATACGAGCGCCTGA -> TCAGATACGAGCGCCTGAC
CGAGGACTCCACAGGTGCC -> GAGGACTCCACAGGTGCCA
ATGATTGAGCGTTTGCCAA -> TGATTGAGCGTTTGCCAAT
GACTGGATTAAGAGTCTGA -> ACTGGATTAAGAGTCTGAT
CCGGCGTCATCGTAGTCGC -> CGGCGTCATCGTAGTCGCC
GACCTACTCACTTTTCCCC -> ACCTACTCACTTTTCCCCG
AGGGCTTGTTAGTTGCTAC -> GGGCTTGTTAGTTGCTACA
GCGCGTCCAACGGACCCCG -> CGCGTCCAACGGACCCCGC
TTCAAGTGAAGGCGAAGAA -> TCAAGTGAAGGCGAAGAAG
CGAAGTTATCAGATACTCC -> GAAGTTATCAGATACTCCT
TATGGTATAGATGCCGTTA -> ATGGTATAGATGCCGTTAA
AAGGCGGTCTGCTGATGTA -> AGGCGGTCTGCTGATGTAT
CAGGAATGAGGCATTCCGC -> AGGAATGAGGCATTCCGCC
ACTTCAGGAATGAGGCATT -> CTTCAGGAATGAGGCATTC
CCGGTATCCCTACGATAGA -> CGGTATCCCTACGATAGAG
CTATGATTGAGCGTTTGCC -> TATGATTGAGCGTTTGCCA
GAAGGCGAAGAAGGAGACT -> AAGGCGAAGAAGGAGACTT
AAAGGGGACTTGACCGACT -> AAGGGGACTTGACCGACTG
CCAACGGACCCCGCGATTT -> CAACGGACCCCGCGATTTA
GCAACTCTTGGGTTCAGGA -> CAACTCTTGGGTTCAGGAA
ACCTGCACTGCAACCGGCG -> CCTGCACTGCAACCGGCGT
AGACGCTAGCTGCAACGAC -> GACGCTAGCTGCAACGACA
CCAGATACGGTTCATACCT -> CAGATACGGTTCATACCTT
ATTTAGAGCGGTTCACCAT -> TTTAGAGCGGTTCACCATC
CACGCACCTGCACTGCAAC -> ACGCACCTGCACTGCAACC
AGATCCTGAGCCCACTCCG -> GATCCTGAGCCCACTCCGC
GTTACGGTCGTTTCCGGTC -> TTACGGTCGTTTCCGGTCG
GACCATTAATCCCACGAGA -> ACCATTAATCCCACGAGAT
AGGCATTCCGCCTCTGCCA -> GGCATTCCGCCTCTGCCAA
CATAGGAAGGACCGCGCAC -> ATAGGAAGGACCGCGCACA
TTTGTGCCCGCTTGCCCTC -> TTGTGCCCGCTTGCCCTCC
AGTTGTCCGCTTTTAGCCA -> GTTGTCCGCTTTTAGCCAC
CGCTAATGCTATTTGTATA -> GCTAATGCTATTTGTATAT
CAGGAACCCAGATACGGTT -> AGGAACCCAGATACGGTTC
CTTTAGGACACCCGCACCA -> TTTAGGACACCCGCACCAA
TTGTGCCCGCTTGCCCTCC -> TGTGCCCGCTTGCCCTCCC
TGGCAGGAACCCAGATACG -> GGCAGGAACCCAGATACGG
AGACGACGCTATGTTAGGC -> GACGACGCTATGTTAGGCT
GATACGGTTCATACCTTTA -> ATACGGTTCATACCTTTAC
CCAAATGAGGTCCGCGTAG -> CAAATGAGGTCCGCGTAGG
CGCGTAGGTTTATGGATCT -> GCGTAGGTTTATGGATCTC
TGTCGCTCACCGTGCCGTA -> GTCGCTCACCGTGCCGTAT
CCGTTCAGACCGAGTAACA -> CGTTCAGACCGAGTAACAT
AACCTCCAGACGGGGCTCC -> ACCTCCAGACGGGGCTCCG
TCCGCGCTACTCGACAACC -> CCGCGCTACTCGACAACCG
ACTGCCGGTGCTCCTTTTA -> CTGCCGGTGCTCCTTTTAG
TATGCCCGCAAAGGAGACC -> ATGCCCGCAAAGGAGACCC
CTCACTTTTCCCCGTGTGT -> TCACTTTTCCCCGTGTGTT
AGGAATGAGGCATTCACGA -> GGAATGAGGCATTCACGAG
GGGTCCCGGTGGTGAGAAA -> GGTCCCGGTGGTGAGAAAT
AACGCGGTGAGTTCACTAT -> ACGCGGTGAGTTCACTATG
GTAGTCGCCAAATATGGTA -> TAGTCGCCAAATATGGTAT
AGTCGCGGGACTGGATTAA -> GTCGCGGGACTGGATTAAG
TTTCGAAAAGAACGACTCA -> TTCGAAAAGAACGACTCAA
AGAGTAGCTCATTTACTTT -> GAGTAGCTCATTTACTTTC
TGTCAAGGCGGTCTGCTGA -> GTCAAGGCGGTCTGCTGAT
GCACATTAAGGACGGCGCA -> CACATTAAGGACGGCGCAA
ATTAACAGGACAGCGTTGG -> TTAACAGGACAGCGTTGGC
ACCTCCGTTCAGACCGAGT -> CCTCCGTTCAGACCGAGTA
ACTACCCCAAATATTCAGG -> CTACCCCAAATATTCAGGA
GCTCATTTACTTTCGTTAC -> CTCATTTACTTTCGTTACG
CAACGGACCCCGCGATTTA -> AACGGACCCCGCGATTTAC
ACGGCACTAAGGAGACCCA -> CGGCACTAAGGAGACCCAT
GACCGCGCACAGAACATGA -> ACCGCGCACAGAACATGAA
CCGCACCAACCATAGGAAG -> CGCACCAACCATAGGAAGG
CTTCACCAGCCTGTCTCTG -> TTCACCAGCCTGTCTCTGT
CGACGCTAATGCTATTTGT -> GACGCTAATGCTATTTGTA
TCCTTATTTTGGCAGGAAC -> CCTTATTTTGGCAGGAACC
ACGAGTGTTAGACGACCAT -> CGAGTGTTAGACGACCATT
AACCTGGTACCTAGTTGTC -> ACCTGGTACCTAGTTGTCC
GGGTAGGCGTCTTGACTCT -> GGTAGGCGTCTTGACTCTC
CTATTTGTGCCCGCTTGCC -> TATTTGTGCCCGCTTGCCC
CACCAACCATAGGAAGGAC -> ACCAACCATAGGAAGGACC
CATCAGGGTACAGTTTCTA -> ATCAGGGTACAGTTTCTAT
TCTGCCAAGGAGACCCATA -> CTGCCAAGGAGACCCATAG
AAGTTATCAGATACTCCTT -> AGTTATCAGATACTCCTTC
GATGTAAGCCGTCGTTCTG -> ATGTAAGCCGTCGTTCTGC
GACAGCGTTGGCTCAGATA -> ACAGCGTTGGCTCAGATAC
GACTCGGTCTGGACGTTGC -> ACTCGGTCTGGACGTTGCC
CACGAGATCCTGAGCCCAC -> ACGAGATCCTGAGCCCACT
GGAACCACTACCCCAAATA -> GAACCACTACCCCAAATAT
GAATGAGGCATTCGTACGG -> AATGAGGCATTCGTACGGC
ACTTGACCGACTGGTGCAC -> CTTGACCGACTGGTGCACT
ACTCACTTTTCCCCGTGTG -> CTCACTTTTCCCCGTGTGT
AAAATTACTCTGACTTAGT -> AAATTACTCTGACTTAGTA
CTAAACCTGGTACCTAGTT -> TAAACCTGGTACCTAGTTG
CTTGAGCGCGTCCAACGGA -> TTGAGCGCGTCCAACGGAC
TAGAGCGGTTCACCATCGC -> AGAGCGGTTCACCATCGCG
CGGGACTGGATTAAGAGTC -> GGGACTGGATTAAGAGTCT
TGCCGTGGGCGAGAGTTTC -> GCCGTGGGCGAGAGTTTCT
ACTGACGAGTTACGCTAGT -> CTGACGAGTTACGCTAGTA
GTTGGATTAAAACCGTGCA -> TTGGATTAAAACCGTGCAC
ATAGCTTCATTGTGCGGTG -> TAGCTTCATTGTGCGGTGA
CACGCACATTAAGGACGGC -> ACGCACATTAAGGACGGCG
ACGAGTTACGCTAGTAAGG -> CGAGTTACGCTAGTAAGGA
TAAAAGAGTAGCTCATTTA -> AAAAGAGTAGCTCATTTAC
AGACCCATAGCTTCATTGT -> GACCCATAGCTTCATTGTG
GTAGAGTAAAAGAGTAGCT -> TAGAGTAAAAGAGTAGCTC
TGATTTAGATGACGGTGCC -> GATTTAGATGACGGTGCCC
TTGTCTATATTGAAGTAGG -> TGTCTATATTGAAGTAGGG
TATGATTGAGCGTTTGCCA -> ATGATTGAGCGTTTGCCAA
CTCTCGGGTTCTAAGCTTA -> TCTCGGGTTCTAAGCTTAG
GTGCACCAGACGACGCTAT -> TGCACCAGACGACGCTATG
TCTGCTGATGTATTATTAG -> CTGCTGATGTATTATTAGG
CAGGGAGGAGGGGAGTTCA -> AGGGAGGAGGGGAGTTCAG
GGACAAGTATCCATCGGCT -> GACAAGTATCCATCGGCTG
TTCATTTCGAAAAGAACGA -> TCATTTCGAAAAGAACGAC
TCTCATCAGGGTACAGTTT -> CTCATCAGGGTACAGTTTC
GACTCCACAGGTGCCAGCT -> ACTCCACAGGTGCCAGCTA
GTTTCGCCGATCGATGGCC -> TTTCGCCGATCGATGGCCA
CCCTAAACCTGGTACCTAG -> CCTAAACCTGGTACCTAGT
AATGCTATTTGTATATAGG -> ATGCTATTTGTATATAGGT
CTCAAGCGTATTTTTCATT -> TCAAGCGTATTTTTCATTT
GGACTTGACCGACTGGTGC -> GACTTGACCGACTGGTGCA
GCTGCGTTGTATGTCATTG -> CTGCGTTGTATGTCATTGA
GTCGTTCTGCCGTGGGCGA -> TCGTTCTGCCGTGGGCGAG
CCTTCCGAGAGTTGTCTAT -> CTTCCGAGAGTTGTCTATA
GATCTCAAGACTTGCTACT -> ATCTCAAGACTTGCTACTA
CGTCTTGACTCTCATCAGG -> GTCTTGACTCTCATCAGGG
AGTCTTACTTGTTTCGCCG -> GTCTTACTTGTTTCGCCGA
CGATCGATGGCCAATTACG -> GATCGATGGCCAATTACGT
TCATTTACTTTCGTTACGG -> CATTTACTTTCGTTACGGT
CTTCATAAGACGGCGATGC -> TTCATAAGACGGCGATGCG
CTTCATTTCGAAAAGAACG -> TTCATTTCGAAAAGAACGA
CAAACTGTGGGACTTGGGC -> AAACTGTGGGACTTGGGCC
TCATACCTTTACTCGGTTC -> CATACCTTTACTCGGTTCA
GGGCGAGAGTTTCTCCTGT -> GGCGAGAGTTTCTCCTGTT
CCCTCATCATCCGAATATT -> CCTCATCATCCGAATATTG
CACCTGCACTGCAACCGGC -> ACCTGCACTGCAACCGGCG
CGTGCACCAGACGACGCTA -> GTGCACCAGACGACGCTAT
TTAGTATGTGGTACTCCTT -> TAGTATGTGGTACTCCTTA
TGCTCTGTTACTTCAGGAA -> GCTCTGTTACTTCAGGAAT
CTTGGGTTCAGGAATGAGG -> TTGGGTTCAGGAATGAGGC
CCGATCGATGGCCAATTAC -> CGATCGATGGCCAATTACG
GTCCAACGGACCCCGCGAT -> TCCAACGGACCCCGCGATT
CGCGGACTATTAACAGGAC -> GCGGACTATTAACAGGACA
TTGTTGGATTAAAACCGTG -> TGTTGGATTAAAACCGTGC
CGGTGCTCCTTTTAGCTAC -> GGTGCTCCTTTTAGCTACA
CACCAGCCTGTCTCTGTCC -> ACCAGCCTGTCTCTGTCCC
AGCCCTCCCCCGTCTTTAG -> GCCCTCCCCCGTCTTTAGG
CTGCCGTGGGCGAGAGTTT -> TGCCGTGGGCGAGAGTTTC
TCTGCACTGCCCTAAACCT -> CTGCACTGCCCTAAACCTG
CGTTTCCGGTCGAGACCAA -> GTTTCCGGTCGAGACCAAA
CAAATGAGGTCCGCGTAGG -> AAATGAGGTCCGCGTAGGT
CGCCGACGAGGCTGCGTTG -> GCCGACGAGGCTGCGTTGT
GTGTCCTGGGGTAGGCGTC -> TGTCCTGGGGTAGGCGTCT
CGAATATTGCTATGACGCC -> GAATATTGCTATGACGCCC
CCGACGCTAATGCTATTTG -> CGACGCTAATGCTATTTGT
CATTGACCTCCGTTCAGAC -> ATTGACCTCCGTTCAGACC
CGTAGCAACTGCGGCATTA -> GTAGCAACTGCGGCATTAG
TACCTAGTTGTCCGCTTTT -> ACCTAGTTGTCCGCTTTTA
CAGTGGCCGAGGACTCCAC -> AGTGGCCGAGGACTCCACA
TCCACCACATGGTCATCCA -> CCACCACATGGTCATCCAG
ACGGTTCATACCTTTACTC -> CGGTTCATACCTTTACTCG
ATTCAGGAATGAGGCATTC -> TTCAGGAATGAGGCATTCA
ATGAGGCATTCCGCCTCTG -> TGAGGCATTCCGCCTCTGC
GCTAGCTGCAACGACACCC -> CTAGCTGCAACGACACCCG
GGTTTGACGGTAGCTCAGG -> GTTTGACGGTAGCTCAGGG
GTGAGTTCACTATGCTACA -> TGAGTTCACTATGCTACAT
CTCCCTCATCATCCGAATA -> TCCCTCATCATCCGAATAT
GATGCCGTTAATAGCGCAG -> ATGCCGTTAATAGCGCAGT
CATAGCTTCATAAAACCTC -> ATAGCTTCATAAAACCTCC
TATTAGGTATTTCAGGAAT -> ATTAGGTATTTCAGGAATG
GCGGTGAGTTCACTATGCT -> CGGTGAGTTCACTATGCTA
GACGAGTTACGCTAGTAAG -> ACGAGTTACGCTAGTAAGG
GTTAGACGACCATTAATCC -> TTAGACGACCATTAATCCC
ATCCCACGAGATCCTGAGC -> TCCCACGAGATCCTGAGCC
GTTAGTTGCTACACTCTCG -> TTAGTTGCTACACTCTCGG
CGTCATCGTAGTCGCCAAA -> GTCATCGTAGTCGCCAAAT
CGACAACCGACGCTAATGC -> GACAACCGACGCTAATGCT
CCGTCGTTCTGCCGTGGGC -> CGTCGTTCTGCCGTGGGCG
CACCATCGCGGCAACTCTT -> ACCATCGCGGCAACTCTTG
GTGGGACTTGGGCCTTGAC -> TGGGACTTGGGCCTTGACG
CCAATTGCTAACGGGACCC -> CAATTGCTAACGGGACCCC
GAACCCAGATACGGTTCAT -> AACCCAGATACGGTTCATA
TGCCTTTCCAAATGAGGTC -> GCCTTTCCAAATGAGGTCC
CTTTGAATAGCGTTGAGTT -> TTTGAATAGCGTTGAGTTA
GGGTTCAGGAATGAGGCAT -> GGTTCAGGAATGAGGCATT
ATTAAGGAGACCCATAGCT -> TTAAGGAGACCCATAGCTT
TCATTGACCTCCGTTCAGA -> CATTGACCTCCGTTCAGAC
AAGGACCGCGCACAGAACA -> AGGACCGCGCACAGAACAT
CGAACTGCTCTGTTACTTC -> GAACTGCTCTGTTACTTCA
AGATCACGCACCTGCACTG -> GATCACGCACCTGCACTGC
CTGCTCTGTTACTTCAGGA -> TGCTCTGTTACTTCAGGAA
CGGAGCCCCGACGAGTGTT -> GGAGCCCCGACGAGTGTTA
GTTGTATGTCATTGACCTC -> TTGTATGTCATTGACCTCC
TTTTCATTTGTTGGATTAA -> TTTCATTTGTTGGATTAAA
AGTAAGGAGCTTCGAACTG -> GTAAGGAGCTTCGAACTGC
AGAGCGGTTCACCATCGCG -> GAGCGGTTCACCATCGCGG
CCGAATATTGCTATGACGC -> CGAATATTGCTATGACGCC
TCCGGCGCGGACTATTAAC -> CCGGCGCGGACTATTAACA
GGACCGGTATCCCTACGAT -> GACCGGTATCCCTACGATA
CGATGGCCAATTACGTGGA -> GATGGCCAATTACGTGGAG
GAACAAGGGGATCGCGGCG -> AACAAGGGGATCGCGGCGG
GAATAGCGTTGAGTTACAG -> AATAGCGTTGAGTTACAGC
CACAGTGGCCGAGGACTCC -> ACAGTGGCCGAGGACTCCA
GGTCTGCTGATGTATTATT -> GTCTGCTGATGTATTATTA
TCTGGACGTTGCCTTTCCA -> CTGGACGTTGCCTTTCCAA
TTGCCCACATTGCACGTCT -> TGCCCACATTGCACGTCTC
GTATTTCAGGAATGAGGCA -> TATTTCAGGAATGAGGCAT
TACTTCAGGAATGAGGCAT -> ACTTCAGGAATGAGGCATT
ACAGTTTCTATAATACCAT -> CAGTTTCTATAATACCATT
TACCATTGGATACTTAGTT -> ACCATTGGATACTTAGTTC
TACTTGAGCGCGTCCAACG -> ACTTGAGCGCGTCCAACGG
CGTTACGGTCGTTTCCGGT -> GTTACGGTCGTTTCCGGTC
AGCGTTGGCTCAGATACGA -> GCGTTGGCTCAGATACGAG
TACTCCTTCCCGGGGTCCC -> ACTCCTTCCCGGGGTCCCG
GAAAAGGGGACTTGACCGA -> AAAAGGGGACTTGACCGAC
GTGGGCGAGAGTTTCTCCT -> TGGGCGAGAGTTTCTCCTG
GCGTCTTGACTCTCATCAG -> CGTCTTGACTCTCATCAGG
AGCGCCTGACGCCTCGCGG -> GCGCCTGACGCCTCGCGGA
GCAGTCTTACTTGTTTCGC -> CAGTCTTACTTGTTTCGCC
TCGTTTCCGGTCGAGACCA -> CGTTTCCGGTCGAGACCAA
GGTTCATACCTTTACTCGG -> GTTCATACCTTTACTCGGT
GACGGCGCAACAGACCAAG -> ACGGCGCAACAGACCAAGA
GGGGAGTTCAGGATTTAGA -> GGGAGTTCAGGATTTAGAG
CCAGACGACGCTATGTTAG -> CAGACGACGCTATGTTAGG
GGGAACATGCTTGCTGTCC -> GGAACATGCTTGCTGTCCG
GACCCATAGCTTCATAAGA -> ACCCATAGCTTCATAAGAC
CCTTTACTCGGTTCACCCT -> CTTTACTCGGTTCACCCTT
TACGGTGGTGTCCTGGGGT -> ACGGTGGTGTCCTGGGGTA
GGACCTACTCACTTTTCCC -> GACCTACTCACTTTTCCCC
TAGCCACTAGGCCTCTTGC -> AGCCACTAGGCCTCTTGCT
TGACGCCCTCAATGTCAAG -> GACGCCCTCAATGTCAAGG
TCATCCAGGGAGGACCTAC -> CATCCAGGGAGGACCTACT
TCGATGATGTAAGCCGTCG -> CGATGATGTAAGCCGTCGT
AGACCGAGTAACATGGGGA -> GACCGAGTAACATGGGGAA
ACTAACTGTAAAGACTCGG -> CTAACTGTAAAGACTCGGT
TATTATTAGGTATTTCAGG -> ATTATTAGGTATTTCAGGA
AGACCCATAGCTTCATAAG -> GACCCATAGCTTCATAAGA
CTACTCGACAACCGACGCT -> TACTCGACAACCGACGCTA
CCAATAAAATTACTCTGAC -> CAATAAAATTACTCTGACT
CTGGGGTAGGCGTCTTGAC -> TGGGGTAGGCGTCTTGACT
GACGGTGCCCTACGTCGAT -> ACGGTGCCCTACGTCGATG
GGCGTCTTGACTCTCATCA -> GCGTCTTGACTCTCATCAG
CGAGTGTTAGACGACCATT -> GAGTGTTAGACGACCATTA
CGAGCGCCTGACGCCTCGC -> GAGCGCCTGACGCCTCGCG
GGACTCCACAGGTGCCAGC -> GACTCCACAGGTGCCAGCT
TCGGGTTCTAAGCTTAGCG -> CGGGTTCTAAGCTTAGCGT
GCGTTAGCTAGTTGCCCAC -> CGTTAGCTAGTTGCCCACA
TACGTCGATGATGTAAGCC -> ACGTCGATGATGTAAGCCG
CATGGTCATCCAGGGAGGA -> ATGGTCATCCAGGGAGGAC
CTTTACTCGGTTCACCCTT -> TTTACTCGGTTCACCCTTC
AACTGCTCTGTTACTTCAG -> ACTGCTCTGTTACTTCAGG
TTACTTTCGTTACGGTCGT -> TACTTTCGTTACGGTCGTT
TCATCAGGGTACAGTTTCT -> CATCAGGGTACAGTTTCTA
TTATTAAGGAGACCCATAG -> TATTAAGGAGACCCATAGC
GTTACGTTATACGGTGGTG -> TTACGTTATACGGTGGTGT
GGAATGAGGCATTCACGAG -> GAATGAGGCATTCACGAGT
AAACTGACTGGATAAGATC -> AACTGACTGGATAAGATCA
AGAAAAGTGATAGAGTAGA -> GAAAAGTGATAGAGTAGAG
TCCGGAACGCGGTGAGTTC -> CCGGAACGCGGTGAGTTCA
TCTCTGTCCCTTCACTGCC -> CTCTGTCCCTTCACTGCCG
TCTTGGGTTCAGGAATGAG -> CTTGGGTTCAGGAATGAGG
TCATTGTGAGTCTTTGAAT -> CATTGTGAGTCTTTGAATA
GTTCATACCTTTACTCGGT -> TTCATACCTTTACTCGGTT
GGTAGGCGTCTTGACTCTC -> GTAGGCGTCTTGACTCTCA
GGGCTCCGGAACGCGGTGA -> GGCTCCGGAACGCGGTGAG
CACCCTTCCGAGAGTTGTC -> ACCCTTCCGAGAGTTGTCT
ACGCTAATGCTATTTGTAT -> CGCTAATGCTATTTGTATA
ATCCCTACGATAGAGGATC -> TCCCTACGATAGAGGATCA
CTTAGTATGTGGTACTCCT -> TTAGTATGTGGTACTCCTT
ACGAGGCTGCGTTGTATGT -> CGAGGCTGCGTTGTATGTC
GGTTCAGGAATGAGGCATT -> GTTCAGGAATGAGGCATTC
CGAGTTATTAAGGAGACCC -> GAGTTATTAAGGAGACCCA
TCCTGGAACAAGGGGATCG -> CCTGGAACAAGGGGATCGC
ATGACGCCCTCAATGTCAA -> TGACGCCCTCAATGTCAAG
ACGCCCTCAATGTCAAGGC -> CGCCCTCAATGTCAAGGCG
TTAGCGTTAGCTAGTTGCC -> TAGCGTTAGCTAGTTGCCC
CCAGCTAACTGACGAGTTA -> CAGCTAACTGACGAGTTAC
GCTAGTAAGGAGCTTCGAA -> CTAGTAAGGAGCTTCGAAC
GGCTCCACCACATGGTCAT -> GCTCCACCACATGGTCATC
ATGAGAGCAGTCTTACTTG -> TGAGAGCAGTCTTACTTGT
TCGGCTGCTATTTGTGCCC -> CGGCTGCTATTTGTGCCCG
GGTCCGCGTAGGTTTATGG -> GTCCGCGTAGGTTTATGGA
ATTATTAGGTATTTCAGGA -> TTATTAGGTATTTCAGGAA
TGACGGTAGCTCAGGGCTT -> GACGGTAGCTCAGGGCTTG
TCAGGAATGAGGCATTCCG -> CAGGAATGAGGCATTCCGC
CATTAGAGACTTAGAAGAC -> ATTAGAGACTTAGAAGACG
TAGTCGCCAAATATGGTAT -> AGTCGCCAAATATGGTATA
ACTCGGTCTGGACGTTGCC -> CTCGGTCTGGACGTTGCCT
AGCTTCATAAGACGGCGAT -> GCTTCATAAGACGGCGATG
TTCCCCGTGTGTTGTCCGG -> TCCCCGTGTGTTGTCCGGC
CTCTGACTTAGTATGTGGT -> TCTGACTTAGTATGTGGTA
GGGACTTGACCGACTGGTG -> GGACTTGACCGACTGGTGC
CACAGGTGCCAGCTAACTG -> ACAGGTGCCAGCTAACTGA
AACGACTCAAGCGTATTTT -> ACGACTCAAGCGTATTTTT
GTCGAGACCAAACTGTGGG -> TCGAGACCAAACTGTGGGA
CAAGTGAAGGCGAAGAAGG -> AAGTGAAGGCGAAGAAGGA
TCGTACGGCACTAAGGAGA -> CGTACGGCACTAAGGAGAC
CTGCACTGCAACCGGCGTC -> TGCACTGCAACCGGCGTCA
GCTTCATTTCGAAAAGAAC -> CTTCATTTCGAAAAGAACG
GGAGACCCATAGCTTCATT -> GAGACCCATAGCTTCATTG, GAGACCCATAGCTTCATTT
CATCATCCGAATATTGCTA -> ATCATCCGAATATTGCTAT
GAGCTTCGAACTGCTCTGT -> AGCTTCGAACTGCTCTGTT
CTCGGTTCACCCTTCCGAG -> TCGGTTCACCCTTCCGAGA
GTGTGTTGTCCGGCGCGGA -> TGTGTTGTCCGGCGCGGAC
TCCTGAGCCCACTCCGCTG -> CCTGAGCCCACTCCGCTGA
TTACGGTCGTTTCCGGTCG -> TACGGTCGTTTCCGGTCGA
TCTGTCCCTTCACTGCCGG -> CTGTCCCTTCACTGCCGGT
TTAGAGACTTAGAAGACGC -> TAGAGACTTAGAAGACGCT
GTAAAGACTCGGTCTGGAC -> TAAAGACTCGGTCTGGACG
TATTTCAGGAATGAGGCAT -> ATTTCAGGAATGAGGCATT
GCCCCGACGAGTGTTAGAC -> CCCCGACGAGTGTTAGACG
GACGACGCTATGTTAGGCT -> ACGACGCTATGTTAGGCTA
CCATAGGAAGGACCGCGCA -> CATAGGAAGGACCGCGCAC
GATACTCCTTCCCGGGGTC -> ATACTCCTTCCCGGGGTCC
ACTGCGGCATTAGAGACTT -> CTGCGGCATTAGAGACTTA
CGTCTCGGCACGCACATTA -> GTCTCGGCACGCACATTAA
ACTGGTGCACTAACTGTAA -> CTGGTGCACTAACTGTAAA
ACACTCTCGGGTTCTAAGC -> CACTCTCGGGTTCTAAGCT
CAGATACGGTTCATACCTT -> AGATACGGTTCATACCTTT
GGGCTCCACCACATGGTCA -> GGCTCCACCACATGGTCAT
TAACTGACGAGTTACGCTA -> AACTGACGAGTTACGCTAG
TAGATGCCGTTAATAGCGC -> AGATGCCGTTAATAGCGCA
GTATCCCTACGATAGAGGA -> TATCCCTACGATAGAGGAT
CAATGTCAAGGCGGTCTGC -> AATGTCAAGGCGGTCTGCT
TCTATATTGAAGTAGGGCT -> CTATATTGAAGTAGGGCTC
GTTATCAGATACTCCTTCC -> TTATCAGATACTCCTTCCC
TCAGGGCTTGTTAGTTGCT -> CAGGGCTTGTTAGTTGCTA
TATACGGTGGTGTCCTGGG -> ATACGGTGGTGTCCTGGGG
AAACCTGGTACCTAGTTGT -> AACCTGGTACCTAGTTGTC
CATTCGTACGGCACTAAGG -> ATTCGTACGGCACTAAGGA
CGGACTATTAACAGGACAG -> GGACTATTAACAGGACAGC
GGAATGAGGCATTCTATGC -> GAATGAGGCATTCTATGCC
GCCACTAGGCCTCTTGCTC -> CCACTAGGCCTCTTGCTCG
CACTGCCGGTGCTCCTTTT -> ACTGCCGGTGCTCCTTTTA
TAGCGTTGAGTTACAGCCA -> AGCGTTGAGTTACAGCCAA
GCGTTTGCCAATAAAATTA -> CGTTTGCCAATAAAATTAC
GCCCGCAAAGGAGACCCAT -> CCCGCAAAGGAGACCCATA
CATAAGACGGCGATGCGAA -> ATAAGACGGCGATGCGAAG
GCCGGTGCTCCTTTTAGCT -> CCGGTGCTCCTTTTAGCTA
TGTCCCTTCACTGCCGGTG -> GTCCCTTCACTGCCGGTGC
AGACGGCGATGCGAAGTTA -> GACGGCGATGCGAAGTTAT
CGGCGATGCGAAGTTATCA -> GGCGATGCGAAGTTATCAG
GACTATTAACAGGACAGCG -> ACTATTAACAGGACAGCGT
AATACGTTACGTTATACGG -> ATACGTTACGTTATACGGT
ATGGATCTCCATAAGAAAA -> TGGATCTCCATAAGAAAAG
TAGTTGTCCGCTTTTAGCC -> AGTTGTCCGCTTTTAGCCA
GCCTTTCCAAATGAGGTCC -> CCTTTCCAAATGAGGTCCG
ACGCTAGCTGCAACGACAC -> CGCTAGCTGCAACGACACC
ACCACATGGTCATCCAGGG -> CCACATGGTCATCCAGGGA
TCTTGCTCGTACTTGAGCG -> CTTGCTCGTACTTGAGCGC
CGGCACGCACATTAAGGAC -> GGCACGCACATTAAGGACG
TAGCTCAGGGCTTGTTAGT -> AGCTCAGGGCTTGTTAGTT
TGTCTCTGTCCCTTCACTG -> GTCTCTGTCCCTTCACTGC
ACCTTTACTCGGTTCACCC -> CCTTTACTCGGTTCACCCT
ATTAATCCCACGAGATCCT -> TTAATCCCACGAGATCCTG
AGCGTAGCAACTGCGGCAT -> GCGTAGCAACTGCGGCATT
TTACTTGTTTCGCCGATCG -> TACTTGTTTCGCCGATCGA
GCGATTTACTTCATGGATC -> CGATTTACTTCATGGATCT
GTTGGCTCAGATACGAGCG -> TTGGCTCAGATACGAGCGC
GGCGCAACAGACCAAGATT -> GCGCAACAGACCAAGATTT
TGCACTAACTGTAAAGACT -> GCACTAACTGTAAAGACTC
AGGCATTCTATGCCCGCAA -> GGCATTCTATGCCCGCAAA
CGGCAACTCTTGGGTTCAG -> GGCAACTCTTGGGTTCAGG
CTCGACAACCGACGCTAAT -> TCGACAACCGACGCTAATG
ATGGCCAATTACGTGGAGG -> TGGCCAATTACGTGGAGGC
TCTTTGAATAGCGTTGAGT -> CTTTGAATAGCGTTGAGTT
CCGCGATTTACTTCATGGA -> CGCGATTTACTTCATGGAT
TCTGACTTAGTATGTGGTA -> CTGACTTAGTATGTGGTAC
TGACGGTGCCCTACGTCGA -> GACGGTGCCCTACGTCGAT
CTCATCATCCGAATATTGC -> TCATCATCCGAATATTGCT
CTATATTGAAGTAGGGCTC -> TATATTGAAGTAGGGCTCC
AACATGAAAAGGGGACTTG -> ACATGAAAAGGGGACTTGA
ACCTCCAGACGGGGCTCCG -> CCTCCAGACGGGGCTCCGG
GCTCCACCACATGGTCATC -> CTCCACCACATGGTCATCC
TTCATTTGTTGGATTAAAA -> TCATTTGTTGGATTAAAAC
TCCGCTTTTAGCCACTAGG -> CCGCTTTTAGCCACTAGGC
TACTCGGTTCACCCTTCCG -> ACTCGGTTCACCCTTCCGA
CTTGTTAGTTGCTACACTC -> TTGTTAGTTGCTACACTCT
TTGTGAGTCTTTGAATAGC -> TGTGAGTCTTTGAATAGCG
CGGCGCAACAGACCAAGAT -> GGCGCAACAGACCAAGATT
ACAGAACATGAAAAGGGGA -> CAGAACATGAAAAGGGGAC
ACCCATAGCTTCATAAAAC -> CCCATAGCTTCATAAAACC
TGGGACTTGGGCCTTGACG -> GGGACTTGGGCCTTGACGC
TCACGCACCTGCACTGCAA -> CACGCACCTGCACTGCAAC
GTGCGGTGACTCTGCACTG -> TGCGGTGACTCTGCACTGC
GTGGTGTCCTGGGGTAGGC -> TGGTGTCCTGGGGTAGGCG
TGCCCGCAAAGGAGACCCA -> GCCCGCAAAGGAGACCCAT
AGGACCGCGCACAGAACAT -> GGACCGCGCACAGAACATG
CGCCCTCAATGTCAAGGCG -> GCCCTCAATGTCAAGGCGG
TTCTATAATACCATTGGAT -> TCTATAATACCATTGGATA
CAACCGACGCTAATGCTAT -> AACCGACGCTAATGCTATT
TCACCGTGCCGTATCATGG -> CACCGTGCCGTATCATGGG
TGCACGTCTCGGCACGCAC -> GCACGTCTCGGCACGCACA
ATACGGTGGTGTCCTGGGG -> TACGGTGGTGTCCTGGGGT
TGTCCGGCGCGGACTATTA -> GTCCGGCGCGGACTATTAA
TGCCAAGGAGACCCATAGC -> GCCAAGGAGACCCATAGCT
CCCTTCCGAGAGTTGTCTA -> CCTTCCGAGAGTTGTCTAT
CCCTCCCCCGTCTTTAGGA -> CCTCCCCCGTCTTTAGGAC
AGAAGGAGACTTCACCAGC -> GAAGGAGACTTCACCAGCC
CATAGCTTCATTGTGCGGT -> ATAGCTTCATTGTGCGGTG
AGGGAGGACCTACTCACTT -> GGGAGGACCTACTCACTTT
GGTGAGTTCACTATGCTAC -> GTGAGTTCACTATGCTACA
CCGTATCATGGGACCGGTA -> CGTATCATGGGACCGGTAT
CAGGTGCCAGCTAACTGAC -> AGGTGCCAGCTAACTGACG
CGTGCCGTATCATGGGACC -> GTGCCGTATCATGGGACCG
ACCTGGTACCTAGTTGTCC -> CCTGGTACCTAGTTGTCCG
GTCCGCGCTACTCGACAAC -> TCCGCGCTACTCGACAACC
GTTATACGGTGGTGTCCTG -> TTATACGGTGGTGTCCTGG
TGTATATAGGTTTGACGGT -> GTATATAGGTTTGACGGTA
CGTTTGCCAATAAAATTAC -> GTTTGCCAATAAAATTACT
ACATTAAGGACGGCGCAAC -> CATTAAGGACGGCGCAACA
AAGGAGCTTCGAACTGCTC -> AGGAGCTTCGAACTGCTCT
TACTTTCGTTACGGTCGTT -> ACTTTCGTTACGGTCGTTT
GGGAGTTCAGGATTTAGAG -> GGAGTTCAGGATTTAGAGC
GGACGTTGCCTTTCCAAAT -> GACGTTGCCTTTCCAAATG
TGAGTTACAGCCAATTGCT -> GAGTTACAGCCAATTGCTA
GTCCACAGGGAGGAGGGGA -> TCCACAGGGAGGAGGGGAG
TCTGCCGTGGGCGAGAGTT -> CTGCCGTGGGCGAGAGTTT
CCCTCATTGTGAGTCTTTG -> CCTCATTGTGAGTCTTTGA
AGACCCATAGCTTCATTTC -> GACCCATAGCTTCATTTCG
TGTGAGTCTTTGAATAGCG -> GTGAGTCTTTGAATAGCGT
GGATTTAGAGCGGTTCACC -> GATTTAGAGCGGTTCACCA
CCACTACCCCAAATATTCA -> CACTACCCCAAATATTCAG
TATGACGCCCTCAATGTCA -> ATGACGCCCTCAATGTCAA
TACAGCCAATTGCTAACGG -> ACAGCCAATTGCTAACGGG
TACGAGCGCCTGACGCCTC -> ACGAGCGCCTGACGCCTCG
AGTATGTGGTACTCCTTAC -> GTATGTGGTACTCCTTACA
AAAGAGTAGCTCATTTACT -> AAGAGTAGCTCATTTACTT
GGTCATCCAGGGAGGACCT -> GTCATCCAGGGAGGACCTA
GCCTTGACGCTGTCCGGGA -> CCTTGACGCTGTCCGGGAA
TTCGAAAAGAACGACTCAA -> TCGAAAAGAACGACTCAAG
GGTGACTCTGCACTGCCCT -> GTGACTCTGCACTGCCCTA
GTTACTTCAGGAATGAGGC -> TTACTTCAGGAATGAGGCA
CGTGGGCGAGAGTTTCTCC -> GTGGGCGAGAGTTTCTCCT
CAGGGAGGACCTACTCACT -> AGGGAGGACCTACTCACTT
AGCTCAGGGCTTGTTAGTT -> GCTCAGGGCTTGTTAGTTG
CTCCACAGGTGCCAGCTAA -> TCCACAGGTGCCAGCTAAC
AGGATTTAGAGCGGTTCAC -> GGATTTAGAGCGGTTCACC
CCACATGGTCATCCAGGGA -> CACATGGTCATCCAGGGAG
CCGCGTAGGTTTATGGATC -> CGCGTAGGTTTATGGATCT
GATTTTTCCCTCATTGTGA -> ATTTTTCCCTCATTGTGAG
GCCAGCTAACTGACGAGTT -> CCAGCTAACTGACGAGTTA
CAGGAATGAGGCATTCACG -> AGGAATGAGGCATTCACGA
TCCCTTCACTGCCGGTGCT -> CCCTTCACTGCCGGTGCTC
TGAGGCATTCCGCCTCTGC -> GAGGCATTCCGCCTCTGCC
ACTATTAACAGGACAGCGT -> CTATTAACAGGACAGCGTT
CGCTATGTTAGGCTATGAT -> GCTATGTTAGGCTATGATT
AACCATAGGAAGGACCGCG -> ACCATAGGAAGGACCGCGC
ACGTTATACGGTGGTGTCC -> CGTTATACGGTGGTGTCCT
CATCCGAATATTGCTATGA -> ATCCGAATATTGCTATGAC
ACTGCCCTAAACCTGGTAC -> CTGCCCTAAACCTGGTACC
ATTACGTGGAGGCTGTCGC -> TTACGTGGAGGCTGTCGCT
TCAGGGTACAGTTTCTATA -> CAGGGTACAGTTTCTATAA
TTACAGCGCAAGCCCGGCA -> TACAGCGCAAGCCCGGCAA
TTCATGGATCTCCATAAGA -> TCATGGATCTCCATAAGAA
GATCACGCACCTGCACTGC -> ATCACGCACCTGCACTGCA
GCTACTATGAGAGCAGTCT -> CTACTATGAGAGCAGTCTT
TGCCCTACGTCGATGATGT -> GCCCTACGTCGATGATGTA
CCCAAATATTCAGGAATGA -> CCAAATATTCAGGAATGAG
ACTTTCGTTACGGTCGTTT -> CTTTCGTTACGGTCGTTTC
GACGGGGCTCCGGAACGCG -> ACGGGGCTCCGGAACGCGG
GGTGCTCCTTTTAGCTACA -> GTGCTCCTTTTAGCTACAA
TGCCGTATCATGGGACCGG -> GCCGTATCATGGGACCGGT
TTTAGGACACCCGCACCAA -> TTAGGACACCCGCACCAAC
GATCGCGGCGGACAAGTAT -> ATCGCGGCGGACAAGTATC
CCAGCCTGTCTCTGTCCCT -> CAGCCTGTCTCTGTCCCTT
AGTTCCTGGAACAAGGGGA -> GTTCCTGGAACAAGGGGAT
TATTAAGGAGACCCATAGC -> ATTAAGGAGACCCATAGCT
CCAAGGAGACCCATAGCTT -> CAAGGAGACCCATAGCTTC
CTCAAGACTTGCTACTATG -> TCAAGACTTGCTACTATGA
AGGAGGGGAGTTCAGGATT -> GGAGGGGAGTTCAGGATTT
GACTTCACCAGCCTGTCTC -> ACTTCACCAGCCTGTCTCT
ACCCCGCGATTTACTTCAT -> CCCCGCGATTTACTTCATG
CTTCATGGATCTCCATAAG -> TTCATGGATCTCCATAAGA
GACAAGTATCCATCGGCTG -> ACAAGTATCCATCGGCTGC
CCCGGGGTCCCGGTGGTGA -> CCGGGGTCCCGGTGGTGAG
ACCCGCACCAACCATAGGA -> CCCGCACCAACCATAGGAA
TCCCTCATTGTGAGTCTTT -> CCCTCATTGTGAGTCTTTG
CCGGCGCGGACTATTAACA -> CGGCGCGGACTATTAACAG
AAAAGTGATAGAGTAGAGT -> AAAGTGATAGAGTAGAGTA
TCCATCGGCTGCTATTTGT -> CCATCGGCTGCTATTTGTG
TTGACGCTGTCCGGGAAAC -> TGACGCTGTCCGGGAAACT
ATTACTCTGACTTAGTATG -> TTACTCTGACTTAGTATGT
TTGTGCGGTGACTCTGCAC -> TGTGCGGTGACTCTGCACT
CGTGTGTTGTCCGGCGCGG -> GTGTGTTGTCCGGCGCGGA
TGGTGTCCTGGGGTAGGCG -> GGTGTCCTGGGGTAGGCGT
TGTGGTACTCCTTACAGCG -> GTGGTACTCCTTACAGCGC
TATTTTGGCAGGAACCCAG -> ATTTTGGCAGGAACCCAGA
GCTAATGCTATTTGTATAT -> CTAATGCTATTTGTATATA
CCCAGATACGGTTCATACC -> CCAGATACGGTTCATACCT
CCGCGCACAGAACATGAAA -> CGCGCACAGAACATGAAAA
GTTGCTACACTCTCGGGTT -> TTGCTACACTCTCGGGTTC
CATGGGACCGGTATCCCTA -> ATGGGACCGGTATCCCTAC
TAGAGTAGAGTAAAAGAGT -> AGAGTAGAGTAAAAGAGTA
GGCCGAGGACTCCACAGGT -> GCCGAGGACTCCACAGGTG
CACCCGTAGTCGCGGGACT -> ACCCGTAGTCGCGGGACTG
TCACCATCGCGGCAACTCT -> CACCATCGCGGCAACTCTT
CGGGAAACTGACTGGATAA -> GGGAAACTGACTGGATAAG
ACCCATAGCTTCATTGTGC -> CCCATAGCTTCATTGTGCG
TTAGCCACTAGGCCTCTTG -> TAGCCACTAGGCCTCTTGC
CTGACGAGTTACGCTAGTA -> TGACGAGTTACGCTAGTAA
GGATTAAAACCGTGCACCA -> GATTAAAACCGTGCACCAG
GAACCACTACCCCAAATAT -> AACCACTACCCCAAATATT
ATTGAGCGTTTGCCAATAA -> TTGAGCGTTTGCCAATAAA
CATTAATCCCACGAGATCC -> ATTAATCCCACGAGATCCT
GCTAACTGACGAGTTACGC -> CTAACTGACGAGTTACGCT
CTCCGCTGAGGAACCACTA -> TCCGCTGAGGAACCACTAC
CAAGACTTGCTACTATGAG -> AAGACTTGCTACTATGAGA
ACTCAAGCGTATTTTTCAT -> CTCAAGCGTATTTTTCATT
GAGTAACATGGGGAACATG -> AGTAACATGGGGAACATGC
CTAGGCCTCTTGCTCGTAC -> TAGGCCTCTTGCTCGTACT
GTTCACTATGCTACATAAG -> TTCACTATGCTACATAAGC
AGAGACTTAGAAGACGCTA -> GAGACTTAGAAGACGCTAG
TTCGCCGACGAGGCTGCGT -> TCGCCGACGAGGCTGCGTT
GACGAGTGTTAGACGACCA -> ACGAGTGTTAGACGACCAT
GCGTATTTTTCATTTGTTG -> CGTATTTTTCATTTGTTGG
CAACCGGCGTCATCGTAGT -> AACCGGCGTCATCGTAGTC
TTAACAGGACAGCGTTGGC -> TAACAGGACAGCGTTGGCT
TCGTAGTCGCCAAATATGG -> CGTAGTCGCCAAATATGGT
ATAGCGCAGTCCACAGGGA -> TAGCGCAGTCCACAGGGAG
TAGGTTTGACGGTAGCTCA -> AGGTTTGACGGTAGCTCAG
TAAGCTTCGCCGACGAGGC -> AAGCTTCGCCGACGAGGCT
GTGATAGAGTAGAGTAAAA -> TGATAGAGTAGAGTAAAAG
GCTGATGTATTATTAGGTA -> CTGATGTATTATTAGGTAT
GCCCGGCAATTCAAGTGAA -> CCCGGCAATTCAAGTGAAG
ACGAGCGCCTGACGCCTCG -> CGAGCGCCTGACGCCTCGC
AACGGGACCCCGTCCTTAT -> ACGGGACCCCGTCCTTATT
CACTTTTCCCCGTGTGTTG -> ACTTTTCCCCGTGTGTTGT
AATGAGGCATTCACGAGTT -> ATGAGGCATTCACGAGTTA
TCGCGGCGGACAAGTATCC -> CGCGGCGGACAAGTATCCA
TTCCGAGAGTTGTCTATAT -> TCCGAGAGTTGTCTATATT
ACAAGTATCCATCGGCTGC -> CAAGTATCCATCGGCTGCT
AGCCCGGCAATTCAAGTGA -> GCCCGGCAATTCAAGTGAA
AATAGCGCAGTCCACAGGG -> ATAGCGCAGTCCACAGGGA
GGAGACCCATAGCTTCATA -> GAGACCCATAGCTTCATAA, GAGACCCATAGCTTCATAA
GTGTTGTCCGGCGCGGACT -> TGTTGTCCGGCGCGGACTA
ATGCTATTTGTATATAGGT -> TGCTATTTGTATATAGGTT
CTAGCTGCAACGACACCCG -> TAGCTGCAACGACACCCGT
ACTCTCGGGTTCTAAGCTT -> CTCTCGGGTTCTAAGCTTA
GTTTGCCAATAAAATTACT -> TTTGCCAATAAAATTACTC
TGAGTTCACTATGCTACAT -> GAGTTCACTATGCTACATA
ACGCACCTGCACTGCAACC -> CGCACCTGCACTGCAACCG
AGGTGCCAGCTAACTGACG -> GGTGCCAGCTAACTGACGA
GGTTTATGGATCTCAAGAC -> GTTTATGGATCTCAAGACT
CCCCGACGAGTGTTAGACG -> CCCGACGAGTGTTAGACGA
ATTCAAGTGAAGGCGAAGA -> TTCAAGTGAAGGCGAAGAA
GGTGGTGTCCTGGGGTAGG -> GTGGTGTCCTGGGGTAGGC
ACCATAGGAAGGACCGCGC -> CCATAGGAAGGACCGCGCA
AGGCGGTCTGCTGATGTAT -> GGCGGTCTGCTGATGTATT
TGCCGTTAATAGCGCAGTC -> GCCGTTAATAGCGCAGTCC
GATAAGATCACGCACCTGC -> ATAAGATCACGCACCTGCA
AGACTCGGTCTGGACGTTG -> GACTCGGTCTGGACGTTGC
CGGCATTAGAGACTTAGAA -> GGCATTAGAGACTTAGAAG
GGCTGTCGCTCACCGTGCC -> GCTGTCGCTCACCGTGCCG
CTTACTTGTTTCGCCGATC -> TTACTTGTTTCGCCGATCG
TAGGCGTCTTGACTCTCAT -> AGGCGTCTTGACTCTCATC
TGTTAGTTGCTACACTCTC -> GTTAGTTGCTACACTCTCG
ATAGGTTTGACGGTAGCTC -> TAGGTTTGACGGTAGCTCA
CCGGTGCTCCTTTTAGCTA -> CGGTGCTCCTTTTAGCTAC
TGCTGTCCGCGCTACTCGA -> GCTGTCCGCGCTACTCGAC
ACATGGGGAACATGCTTGC -> CATGGGGAACATGCTTGCT
CATAGCTTCATAAGACGGC -> ATAGCTTCATAAGACGGCG
AGGGAGGAGGGGAGTTCAG -> GGGAGGAGGGGAGTTCAGG
TAGTATGTGGTACTCCTTA -> AGTATGTGGTACTCCTTAC
GCGTTGAGTTACAGCCAAT -> CGTTGAGTTACAGCCAATT
CCTTTCCAAATGAGGTCCG -> CTTTCCAAATGAGGTCCGC
AAGGAGACCCATAGCTTCA -> AGGAGACCCATAGCTTCAT, AGGAGACCCATAGCTTCAT, AGGAGACCCATAGCTTCAT, AGGAGACCCATAGCTTCAT
AGATACGAGCGCCTGACGC -> GATACGAGCGCCTGACGCC
TGAGTCTTTGAATAGCGTT -> GAGTCTTTGAATAGCGTTG
AGACCAAACTGTGGGACTT -> GACCAAACTGTGGGACTTG
GAGGCATTCACGAGTTATT -> AGGCATTCACGAGTTATTA
TCGCCGATCGATGGCCAAT -> CGCCGATCGATGGCCAATT
TTAGAGCGGTTCACCATCG -> TAGAGCGGTTCACCATCGC
TTTACTCGGTTCACCCTTC -> TTACTCGGTTCACCCTTCC
GACCCATAGCTTCATTGTG -> ACCCATAGCTTCATTGTGC
GGATCTCCATAAGAAAAGT -> GATCTCCATAAGAAAAGTG
TTGGGCCTTGACGCTGTCC -> TGGGCCTTGACGCTGTCCG
ATAAGACGGCGATGCGAAG -> TAAGACGGCGATGCGAAGT
GGTATAGATGCCGTTAATA -> GTATAGATGCCGTTAATAG
GACGCTGTCCGGGAAACTG -> ACGCTGTCCGGGAAACTGA
CTGACGCCTCGCGGAGCCC -> TGACGCCTCGCGGAGCCCC
CTGGTGCACTAACTGTAAA -> TGGTGCACTAACTGTAAAG
ATACGAGCGCCTGACGCCT -> TACGAGCGCCTGACGCCTC
GAGTTACGCTAGTAAGGAG -> AGTTACGCTAGTAAGGAGC
CTACTCACTTTTCCCCGTG -> TACTCACTTTTCCCCGTGT
AGTTATCAGATACTCCTTC -> GTTATCAGATACTCCTTCC
AGGACTCCACAGGTGCCAG -> GGACTCCACAGGTGCCAGC
CGTTACGTTATACGGTGGT -> GTTACGTTATACGGTGGTG
AGGCATTCACGAGTTATTA -> GGCATTCACGAGTTATTAA
TACCTTTACTCGGTTCACC -> ACCTTTACTCGGTTCACCC
GGTGAGAAATACGTTACGT -> GTGAGAAATACGTTACGTT
CGCTAGCTGCAACGACACC -> GCTAGCTGCAACGACACCC
GTTCTAAGCTTAGCGTAGC -> TTCTAAGCTTAGCGTAGCA
TGACGCTGTCCGGGAAACT -> GACGCTGTCCGGGAAACTG
CGGACAAGTATCCATCGGC -> GGACAAGTATCCATCGGCT
CGGGGTCCCGGTGGTGAGA -> GGGGTCCCGGTGGTGAGAA
CGCGGCAACTCTTGGGTTC -> GCGGCAACTCTTGGGTTCA
TTCTGCCGTGGGCGAGAGT -> TCTGCCGTGGGCGAGAGTT
CCTGTCTCTGTCCCTTCAC -> CTGTCTCTGTCCCTTCACT
TGGCTCAGATACGAGCGCC -> GGCTCAGATACGAGCGCCT
AAAGAACGACTCAAGCGTA -> AAGAACGACTCAAGCGTAT
ATGATGTAAGCCGTCGTTC -> TGATGTAAGCCGTCGTTCT
TTCGTTACGGTCGTTTCCG -> TCGTTACGGTCGTTTCCGG
GTTAGCTAGTTGCCCACAT -> TTAGCTAGTTGCCCACATT
GTAGGTTTATGGATCTCAA -> TAGGTTTATGGATCTCAAG
AGTGATAGAGTAGAGTAAA -> GTGATAGAGTAGAGTAAAA
GAGAGTTGTCTATATTGAA -> AGAGTTGTCTATATTGAAG
GAATATTGCTATGACGCCC -> AATATTGCTATGACGCCCT
CCCGTGTGTTGTCCGGCGC -> CCGTGTGTTGTCCGGCGCG
CTGTTAGCGTTAGCTAGTT -> TGTTAGCGTTAGCTAGTTG
CCGCGCTACTCGACAACCG -> CGCGCTACTCGACAACCGA
CTCGGCACGCACATTAAGG -> TCGGCACGCACATTAAGGA
GAGTTTCTCCTGTTAGCGT -> AGTTTCTCCTGTTAGCGTT
CACTGCCCTAAACCTGGTA -> ACTGCCCTAAACCTGGTAC
GACGCTAGCTGCAACGACA -> ACGCTAGCTGCAACGACAC
TATATAGGTTTGACGGTAG -> ATATAGGTTTGACGGTAGC
GGGGCTCCGGAACGCGGTG -> GGGCTCCGGAACGCGGTGA
CTATGTTAGGCTATGATTG -> TATGTTAGGCTATGATTGA
TGGGCCTTGACGCTGTCCG -> GGGCCTTGACGCTGTCCGG
CGTTAGCTAGTTGCCCACA -> GTTAGCTAGTTGCCCACAT
AGTTCACTATGCTACATAA -> GTTCACTATGCTACATAAG
CTCCACCACATGGTCATCC -> TCCACCACATGGTCATCCA
TTGTATGTCATTGACCTCC -> TGTATGTCATTGACCTCCG
GGTTCTAAGCTTAGCGTAG -> GTTCTAAGCTTAGCGTAGC
CAGACCAAGATTTTTCCCT -> AGACCAAGATTTTTCCCTC
ACCAGCCTGTCTCTGTCCC -> CCAGCCTGTCTCTGTCCCT
AAACCGTGCACCAGACGAC -> AACCGTGCACCAGACGACG
GCCCACATTGCACGTCTCG -> CCCACATTGCACGTCTCGG
CGGTGGTGTCCTGGGGTAG -> GGTGGTGTCCTGGGGTAGG
CTGGATTAAGAGTCTGATT -> TGGATTAAGAGTCTGATTT
GAGGAGGGGAGTTCAGGAT -> AGGAGGGGAGTTCAGGATT
GAGCCCACTCCGCTGAGGA -> AGCCCACTCCGCTGAGGAA
CCCGCTTGCCCTCCCTCAT -> CCGCTTGCCCTCCCTCATC
ACCCATAGCTTCATTTCGA -> CCCATAGCTTCATTTCGAA
TCCGAGAGTTGTCTATATT -> CCGAGAGTTGTCTATATTG
CTCTTGGGTTCAGGAATGA -> TCTTGGGTTCAGGAATGAG
GCCCTACGTCGATGATGTA -> CCCTACGTCGATGATGTAA
TTCCCTCATTGTGAGTCTT -> TCCCTCATTGTGAGTCTTT
ATGAAAAGGGGACTTGACC -> TGAAAAGGGGACTTGACCG
TCACGAGTTATTAAGGAGA -> CACGAGTTATTAAGGAGAC
TTAAGGAGACCCATAGCTT -> TAAGGAGACCCATAGCTTC
GATGTATTATTAGGTATTT -> ATGTATTATTAGGTATTTC
TTGGGTTCAGGAATGAGGC -> TGGGTTCAGGAATGAGGCA
CCCATAGCTTCATAAGACG -> CCATAGCTTCATAAGACGG
CGCGCACAGAACATGAAAA -> GCGCACAGAACATGAAAAG
ACTAAGGAGACCCATAGCT -> CTAAGGAGACCCATAGCTT
AGAAATACGTTACGTTATA -> GAAATACGTTACGTTATAC
TCCGTTCAGACCGAGTAAC -> CCGTTCAGACCGAGTAACA
TTTCTCCTGTTAGCGTTAG -> TTCTCCTGTTAGCGTTAGC
GGACCCCGTCCTTATTTTG -> GACCCCGTCCTTATTTTGG
AGGAGACCCATAGCTTCAT -> GGAGACCCATAGCTTCATT, GGAGACCCATAGCTTCATT, GGAGACCCATAGCTTCATA, GGAGACCCATAGCTTCATA
TTCCGGTCGAGACCAAACT -> TCCGGTCGAGACCAAACTG
AAGTATCCATCGGCTGCTA -> AGTATCCATCGGCTGCTAT
GCTCAGGGCTTGTTAGTTG -> CTCAGGGCTTGTTAGTTGC
TTTCCCTCATTGTGAGTCT -> TTCCCTCATTGTGAGTCTT
GTCGTTTCCGGTCGAGACC -> TCGTTTCCGGTCGAGACCA
CTAACTGACGAGTTACGCT -> TAACTGACGAGTTACGCTA
CGTACGGCACTAAGGAGAC -> GTACGGCACTAAGGAGACC
GCACGTCTCGGCACGCACA -> CACGTCTCGGCACGCACAT
TAGCTCATTTACTTTCGTT -> AGCTCATTTACTTTCGTTA
GCATTCACGAGTTATTAAG -> CATTCACGAGTTATTAAGG
TAACAGGACAGCGTTGGCT -> AACAGGACAGCGTTGGCTC
CTCTGCCAAGGAGACCCAT -> TCTGCCAAGGAGACCCATA
TTCTATGCCCGCAAAGGAG -> TCTATGCCCGCAAAGGAGA
AATACCATTGGATACTTAG -> ATACCATTGGATACTTAGT
GTGCACTAACTGTAAAGAC -> TGCACTAACTGTAAAGACT
GGGGAACATGCTTGCTGTC -> GGGAACATGCTTGCTGTCC
AGGTATTTCAGGAATGAGG -> GGTATTTCAGGAATGAGGC
AACTGCGGCATTAGAGACT -> ACTGCGGCATTAGAGACTT
CCATTAATCCCACGAGATC -> CATTAATCCCACGAGATCC
ACAGGACAGCGTTGGCTCA -> CAGGACAGCGTTGGCTCAG
CTGTCCGCGCTACTCGACA -> TGTCCGCGCTACTCGACAA
TACTTAGTTCCTGGAACAA -> ACTTAGTTCCTGGAACAAG
CGGTAGCTCAGGGCTTGTT -> GGTAGCTCAGGGCTTGTTA
ATGAGGCATTCGTACGGCA -> TGAGGCATTCGTACGGCAC
CCCTCCCTCATCATCCGAA -> CCTCCCTCATCATCCGAAT
CATGGATCTCCATAAGAAA -> ATGGATCTCCATAAGAAAA
GGCGCGGACTATTAACAGG -> GCGCGGACTATTAACAGGA
GTAAGGAGCTTCGAACTGC -> TAAGGAGCTTCGAACTGCT
TGTTAGCGTTAGCTAGTTG -> GTTAGCGTTAGCTAGTTGC
AGTCTTTGAATAGCGTTGA -> GTCTTTGAATAGCGTTGAG
ACTTAGAAGACGCTAGCTG -> CTTAGAAGACGCTAGCTGC
GTCTGATTTAGATGACGGT -> TCTGATTTAGATGACGGTG
CACCCGCACCAACCATAGG -> ACCCGCACCAACCATAGGA
GGTGCCCTACGTCGATGAT -> GTGCCCTACGTCGATGATG
GGGGACTTGACCGACTGGT -> GGGACTTGACCGACTGGTG
ATTGTGCGGTGACTCTGCA -> TTGTGCGGTGACTCTGCAC
GACCAAACTGTGGGACTTG -> ACCAAACTGTGGGACTTGG
AGCCCACTCCGCTGAGGAA -> GCCCACTCCGCTGAGGAAC
TATGTTAGGCTATGATTGA -> ATGTTAGGCTATGATTGAG
TCTTGACTCTCATCAGGGT -> CTTGACTCTCATCAGGGTA
GCGCAAGCCCGGCAATTCA -> CGCAAGCCCGGCAATTCAA
ACCCCAAATATTCAGGAAT -> CCCCAAATATTCAGGAATG
TAGGACACCCGCACCAACC -> AGGACACCCGCACCAACCA
GTTTATGGATCTCAAGACT -> TTTATGGATCTCAAGACTT
CGCTACTCGACAACCGACG -> GCTACTCGACAACCGACGC
ACTATGCTACATAAGCTTC -> CTATGCTACATAAGCTTCG
AGCCAATTGCTAACGGGAC -> GCCAATTGCTAACGGGACC
CACTACCCCAAATATTCAG -> ACTACCCCAAATATTCAGG
GAAAAGAACGACTCAAGCG -> AAAAGAACGACTCAAGCGT
TAGTTGCTACACTCTCGGG -> AGTTGCTACACTCTCGGGT
TCAAGACTTGCTACTATGA -> CAAGACTTGCTACTATGAG
TGAGGCATTCACGAGTTAT -> GAGGCATTCACGAGTTATT
GGACTATTAACAGGACAGC -> GACTATTAACAGGACAGCG
GAATGAGGCATTCCGCCTC -> AATGAGGCATTCCGCCTCT
ACCATCGCGGCAACTCTTG -> CCATCGCGGCAACTCTTGG
ACTCTTGGGTTCAGGAATG -> CTCTTGGGTTCAGGAATGA
TGCTCGTACTTGAGCGCGT -> GCTCGTACTTGAGCGCGTC
GCGTCCAACGGACCCCGCG -> CGTCCAACGGACCCCGCGA
GCATTCGTACGGCACTAAG -> CATTCGTACGGCACTAAGG
ACTCCGCTGAGGAACCACT -> CTCCGCTGAGGAACCACTA
TGAGGAACCACTACCCCAA -> GAGGAACCACTACCCCAAA
ATAATACCATTGGATACTT -> TAATACCATTGGATACTTA
CTAGTTGTCCGCTTTTAGC -> TAGTTGTCCGCTTTTAGCC
AAGCCCGGCAATTCAAGTG -> AGCCCGGCAATTCAAGTGA
CTCGTACTTGAGCGCGTCC -> TCGTACTTGAGCGCGTCCA
CCAACCATAGGAAGGACCG -> CAACCATAGGAAGGACCGC
ACGCACATTAAGGACGGCG -> CGCACATTAAGGACGGCGC
CTATGACGCCCTCAATGTC -> TATGACGCCCTCAATGTCA
GTGACTCTGCACTGCCCTA -> TGACTCTGCACTGCCCTAA
ACGCGGTGAGTTCACTATG -> CGCGGTGAGTTCACTATGC
GGTGTCCTGGGGTAGGCGT -> GTGTCCTGGGGTAGGCGTC
GAGCGGTTCACCATCGCGG -> AGCGGTTCACCATCGCGGC
GAGACCCATAGCTTCATTT -> AGACCCATAGCTTCATTTC
CTCATTGTGAGTCTTTGAA -> TCATTGTGAGTCTTTGAAT
TCTCAAGACTTGCTACTAT -> CTCAAGACTTGCTACTATG
TCCCGGGGTCCCGGTGGTG -> CCCGGGGTCCCGGTGGTGA
TTGACCTCCGTTCAGACCG -> TGACCTCCGTTCAGACCGA
GTAGCTCATTTACTTTCGT -> TAGCTCATTTACTTTCGTT
ACGACTCAAGCGTATTTTT -> CGACTCAAGCGTATTTTTC
GGTTCACCCTTCCGAGAGT -> GTTCACCCTTCCGAGAGTT
TGCCAGCTAACTGACGAGT -> GCCAGCTAACTGACGAGTT
CGCCAAATATGGTATAGAT -> GCCAAATATGGTATAGATG
TTAAAACCGTGCACCAGAC -> TAAAACCGTGCACCAGACG
GACGAGGCTGCGTTGTATG -> ACGAGGCTGCGTTGTATGT
TGCTTGCTGTCCGCGCTAC -> GCTTGCTGTCCGCGCTACT
TATCATGGGACCGGTATCC -> ATCATGGGACCGGTATCCC
CGCTAGTAAGGAGCTTCGA -> GCTAGTAAGGAGCTTCGAA
CAATTGCTAACGGGACCCC -> AATTGCTAACGGGACCCCG
ATGTGGTACTCCTTACAGC -> TGTGGTACTCCTTACAGCG
GCAATTCAAGTGAAGGCGA -> CAATTCAAGTGAAGGCGAA
GAGCGCCTGACGCCTCGCG -> AGCGCCTGACGCCTCGCGG
AGGTTTGACGGTAGCTCAG -> GGTTTGACGGTAGCTCAGG
ATTAGAGACTTAGAAGACG -> TTAGAGACTTAGAAGACGC
CGTGGAGGCTGTCGCTCAC -> GTGGAGGCTGTCGCTCACC
GGTTCACCATCGCGGCAAC -> GTTCACCATCGCGGCAACT
AAGATTTTTCCCTCATTGT -> AGATTTTTCCCTCATTGTG
ACCGGTATCCCTACGATAG -> CCGGTATCCCTACGATAGA
CCTCCCCCGTCTTTAGGAC -> CTCCCCCGTCTTTAGGACA
CTATTTGTATATAGGTTTG -> TATTTGTATATAGGTTTGA
CGACGAGGCTGCGTTGTAT -> GACGAGGCTGCGTTGTATG
CCGCTTGCCCTCCCTCATC -> CGCTTGCCCTCCCTCATCA
ATTCGTACGGCACTAAGGA -> TTCGTACGGCACTAAGGAG
GGCATTCGTACGGCACTAA -> GCATTCGTACGGCACTAAG
CTTGACCGACTGGTGCACT -> TTGACCGACTGGTGCACTA
GTCAAGGCGGTCTGCTGAT -> TCAAGGCGGTCTGCTGATG
TTACAGCCCTCCCCCGTCT -> TACAGCCCTCCCCCGTCTT
TTTTTCATTTGTTGGATTA -> TTTTCATTTGTTGGATTAA
TGGGTTCAGGAATGAGGCA -> GGGTTCAGGAATGAGGCAT
GTCTATATTGAAGTAGGGC -> TCTATATTGAAGTAGGGCT
GAAACTGACTGGATAAGAT -> AAACTGACTGGATAAGATC
AGTCTGATTTAGATGACGG -> GTCTGATTTAGATGACGGT
GGTATCCCTACGATAGAGG -> GTATCCCTACGATAGAGGA
TCACTATGCTACATAAGCT -> CACTATGCTACATAAGCTT
TGCGGTGACTCTGCACTGC -> GCGGTGACTCTGCACTGCC
GAAAAGTGATAGAGTAGAG -> AAAAGTGATAGAGTAGAGT
ATGGATCTCAAGACTTGCT -> TGGATCTCAAGACTTGCTA
GCGCCTGACGCCTCGCGGA -> CGCCTGACGCCTCGCGGAG
CTGATTTAGATGACGGTGC -> TGATTTAGATGACGGTGCC
AAATTACTCTGACTTAGTA -> AATTACTCTGACTTAGTAT
CGCGGCGGACAAGTATCCA -> GCGGCGGACAAGTATCCAT
AAGCTTCGCCGACGAGGCT -> AGCTTCGCCGACGAGGCTG
CTTCCGAGAGTTGTCTATA -> TTCCGAGAGTTGTCTATAT
CGCTCACCGTGCCGTATCA -> GCTCACCGTGCCGTATCAT
ACGGGGCTCCGGAACGCGG -> CGGGGCTCCGGAACGCGGT
GAGGCATTCTATGCCCGCA -> AGGCATTCTATGCCCGCAA
CCCGGCAATTCAAGTGAAG -> CCGGCAATTCAAGTGAAGG
GAGGTCCGCGTAGGTTTAT -> AGGTCCGCGTAGGTTTATG
ATGGGGAACATGCTTGCTG -> TGGGGAACATGCTTGCTGT
ATGTATTATTAGGTATTTC -> TGTATTATTAGGTATTTCA
AAGACGGCGATGCGAAGTT -> AGACGGCGATGCGAAGTTA
GGACAGCGTTGGCTCAGAT -> GACAGCGTTGGCTCAGATA
CCAGGGAGGACCTACTCAC -> CAGGGAGGACCTACTCACT
CAACTCTTGGGTTCAGGAA -> AACTCTTGGGTTCAGGAAT
CGCACAGAACATGAAAAGG -> GCACAGAACATGAAAAGGG
CCCCCGTCTTTAGGACACC -> CCCCGTCTTTAGGACACCC
CTGCGGCATTAGAGACTTA -> TGCGGCATTAGAGACTTAG
ATATTGAAGTAGGGCTCCA -> TATTGAAGTAGGGCTCCAC
TTCATAAGACGGCGATGCG -> TCATAAGACGGCGATGCGA
CGGTGACTCTGCACTGCCC -> GGTGACTCTGCACTGCCCT
CCGGGGTCCCGGTGGTGAG -> CGGGGTCCCGGTGGTGAGA
TGCTAACGGGACCCCGTCC -> GCTAACGGGACCCCGTCCT
CGCGATTTACTTCATGGAT -> GCGATTTACTTCATGGATC
TTATACGGTGGTGTCCTGG -> TATACGGTGGTGTCCTGGG
ACTGACTGGATAAGATCAC -> CTGACTGGATAAGATCACG
CCCTACGTCGATGATGTAA -> CCTACGTCGATGATGTAAG
GCGTAGGTTTATGGATCTC -> CGTAGGTTTATGGATCTCA
CCCGGTGGTGAGAAATACG -> CCGGTGGTGAGAAATACGT
ATGAGGTCCGCGTAGGTTT -> TGAGGTCCGCGTAGGTTTA
AAGAGTAGCTCATTTACTT -> AGAGTAGCTCATTTACTTT
GAGCAGTCTTACTTGTTTC -> AGCAGTCTTACTTGTTTCG
ACGCTGTCCGGGAAACTGA -> CGCTGTCCGGGAAACTGAC
ACAGCCAATTGCTAACGGG -> CAGCCAATTGCTAACGGGA
TAGCTGCAACGACACCCGT -> AGCTGCAACGACACCCGTA
GAGTAGCTCATTTACTTTC -> AGTAGCTCATTTACTTTCG
TCAGGAATGAGGCATTCGT -> CAGGAATGAGGCATTCGTA
AAATACGTTACGTTATACG -> AATACGTTACGTTATACGG
AGTAAAAGAGTAGCTCATT -> GTAAAAGAGTAGCTCATTT
TTGGATTAAAACCGTGCAC -> TGGATTAAAACCGTGCACC
TCTGATTTAGATGACGGTG -> CTGATTTAGATGACGGTGC
AAAAGAACGACTCAAGCGT -> AAAGAACGACTCAAGCGTA
TCCTGGGGTAGGCGTCTTG -> CCTGGGGTAGGCGTCTTGA
AATTCAAGTGAAGGCGAAG -> ATTCAAGTGAAGGCGAAGA
GCTTCGAACTGCTCTGTTA -> CTTCGAACTGCTCTGTTAC
TGCGAAGTTATCAGATACT -> GCGAAGTTATCAGATACTC
GGAGTTCAGGATTTAGAGC -> GAGTTCAGGATTTAGAGCG
GAGTTACAGCCAATTGCTA -> AGTTACAGCCAATTGCTAA
AGTAGAGTAAAAGAGTAGC -> GTAGAGTAAAAGAGTAGCT
GAGTAGAGTAAAAGAGTAG -> AGTAGAGTAAAAGAGTAGC
CCGCTGAGGAACCACTACC -> CGCTGAGGAACCACTACCC
ATTAAGAGTCTGATTTAGA -> TTAAGAGTCTGATTTAGAT
CAGCTAACTGACGAGTTAC -> AGCTAACTGACGAGTTACG
CAGGGTACAGTTTCTATAA -> AGGGTACAGTTTCTATAAT
GGCTGCTATTTGTGCCCGC -> GCTGCTATTTGTGCCCGCT
TCTCGGCACGCACATTAAG -> CTCGGCACGCACATTAAGG
CTGTCGCTCACCGTGCCGT -> TGTCGCTCACCGTGCCGTA
GACTCAAGCGTATTTTTCA -> ACTCAAGCGTATTTTTCAT
TTTGTATATAGGTTTGACG -> TTGTATATAGGTTTGACGG
GCCGTTAATAGCGCAGTCC -> CCGTTAATAGCGCAGTCCA
TGACCTCCGTTCAGACCGA -> GACCTCCGTTCAGACCGAG
ACATAAGCTTCGCCGACGA -> CATAAGCTTCGCCGACGAG
ACGACACCCGTAGTCGCGG -> CGACACCCGTAGTCGCGGG
AGACGACCATTAATCCCAC -> GACGACCATTAATCCCACG
TTGTCCGGCGCGGACTATT -> TGTCCGGCGCGGACTATTA
AACTGTGGGACTTGGGCCT -> ACTGTGGGACTTGGGCCTT
AAGTGATAGAGTAGAGTAA -> AGTGATAGAGTAGAGTAAA
TAAGGAGACCCATAGCTTC -> AAGGAGACCCATAGCTTCA, AAGGAGACCCATAGCTTCA
ACTTGAGCGCGTCCAACGG -> CTTGAGCGCGTCCAACGGA
TGTATTATTAGGTATTTCA -> GTATTATTAGGTATTTCAG
CTGACTTAGTATGTGGTAC -> TGACTTAGTATGTGGTACT
TATTTTTCATTTGTTGGAT -> ATTTTTCATTTGTTGGATT
CCAGACGGGGCTCCGGAAC -> CAGACGGGGCTCCGGAACG
GCGTCATCGTAGTCGCCAA -> CGTCATCGTAGTCGCCAAA
CTAGTAAGGAGCTTCGAAC -> TAGTAAGGAGCTTCGAACT
TTCATTGTGCGGTGACTCT -> TCATTGTGCGGTGACTCTG
GTACTCCTTACAGCGCAAG -> TACTCCTTACAGCGCAAGC
TCAATGTCAAGGCGGTCTG -> CAATGTCAAGGCGGTCTGC
GATAGAGTAGAGTAAAAGA -> ATAGAGTAGAGTAAAAGAG
GTTTCTCCTGTTAGCGTTA -> TTTCTCCTGTTAGCGTTAG
GCCAATTACGTGGAGGCTG -> CCAATTACGTGGAGGCTGT
GCTACACTCTCGGGTTCTA -> CTACACTCTCGGGTTCTAA
TTAATCCCACGAGATCCTG -> TAATCCCACGAGATCCTGA
TCGATGGCCAATTACGTGG -> CGATGGCCAATTACGTGGA
ATGCCCGCAAAGGAGACCC -> TGCCCGCAAAGGAGACCCA
CAAGGCGGTCTGCTGATGT -> AAGGCGGTCTGCTGATGTA
CAGCCTGTCTCTGTCCCTT -> AGCCTGTCTCTGTCCCTTC
TTTCGCCGATCGATGGCCA -> TTCGCCGATCGATGGCCAA
CCTGCACTGCAACCGGCGT -> CTGCACTGCAACCGGCGTC
TGTAAAGACTCGGTCTGGA -> GTAAAGACTCGGTCTGGAC
CCGTGTGTTGTCCGGCGCG -> CGTGTGTTGTCCGGCGCGG
GGCATTAGAGACTTAGAAG -> GCATTAGAGACTTAGAAGA
ATCACAGTGGCCGAGGACT -> TCACAGTGGCCGAGGACTC
TGGTACCTAGTTGTCCGCT -> GGTACCTAGTTGTCCGCTT
TATAGGTTTGACGGTAGCT -> ATAGGTTTGACGGTAGCTC
CGACGAGTGTTAGACGACC -> GACGAGTGTTAGACGACCA
CTTAGCGTAGCAACTGCGG -> TTAGCGTAGCAACTGCGGC
TGAGAAATACGTTACGTTA -> GAGAAATACGTTACGTTAT
TGGATCTCCATAAGAAAAG -> GGATCTCCATAAGAAAAGT
CTCGCGGAGCCCCGACGAG -> TCGCGGAGCCCCGACGAGT
CCCACATTGCACGTCTCGG -> CCACATTGCACGTCTCGGC
CTGCACTGCCCTAAACCTG -> TGCACTGCCCTAAACCTGG
GGACCCCGCGATTTACTTC -> GACCCCGCGATTTACTTCA
TCAGATACTCCTTCCCGGG -> CAGATACTCCTTCCCGGGG
CCATTGGATACTTAGTTCC -> CATTGGATACTTAGTTCCT
CTTCACTGCCGGTGCTCCT -> TTCACTGCCGGTGCTCCTT
ACATGCTTGCTGTCCGCGC -> CATGCTTGCTGTCCGCGCT
TGTTAGGCTATGATTGAGC -> GTTAGGCTATGATTGAGCG
CCCCAAATATTCAGGAATG -> CCCAAATATTCAGGAATGA
TGTATGTCATTGACCTCCG -> GTATGTCATTGACCTCCGT
TAAGCCGTCGTTCTGCCGT -> AAGCCGTCGTTCTGCCGTG
GTATAGATGCCGTTAATAG -> TATAGATGCCGTTAATAGC
ACTTAGTATGTGGTACTCC -> CTTAGTATGTGGTACTCCT
GTAGGCGTCTTGACTCTCA -> TAGGCGTCTTGACTCTCAT
CGGTGGTGAGAAATACGTT -> GGTGGTGAGAAATACGTTA
TAGGCCTCTTGCTCGTACT -> AGGCCTCTTGCTCGTACTT
ATCCGAATATTGCTATGAC -> TCCGAATATTGCTATGACG
GCACCAGACGACGCTATGT -> CACCAGACGACGCTATGTT
CAAGCCCGGCAATTCAAGT -> AAGCCCGGCAATTCAAGTG
CCGTAGTCGCGGGACTGGA -> CGTAGTCGCGGGACTGGAT
TCCGGTCGAGACCAAACTG -> CCGGTCGAGACCAAACTGT
TTAGATGACGGTGCCCTAC -> TAGATGACGGTGCCCTACG
ATTTTGGCAGGAACCCAGA -> TTTTGGCAGGAACCCAGAT
CCAAGATTTTTCCCTCATT -> CAAGATTTTTCCCTCATTG
TAAAATTACTCTGACTTAG -> AAAATTACTCTGACTTAGT
CAGCCCTCCCCCGTCTTTA -> AGCCCTCCCCCGTCTTTAG
GCTCGTACTTGAGCGCGTC -> CTCGTACTTGAGCGCGTCC
TACGGCACTAAGGAGACCC -> ACGGCACTAAGGAGACCCA
AACTCTTGGGTTCAGGAAT -> ACTCTTGGGTTCAGGAATG
GTGAAGGCGAAGAAGGAGA -> TGAAGGCGAAGAAGGAGAC
TTCAGGAATGAGGCATTCG -> TCAGGAATGAGGCATTCGT
GACCCCGTCCTTATTTTGG -> ACCCCGTCCTTATTTTGGC
TATAGATGCCGTTAATAGC -> ATAGATGCCGTTAATAGCG
TAGATGACGGTGCCCTACG -> AGATGACGGTGCCCTACGT
CCCACTCCGCTGAGGAACC -> CCACTCCGCTGAGGAACCA
AAGTAGGGCTCCACCACAT -> AGTAGGGCTCCACCACATG
TGAATAGCGTTGAGTTACA -> GAATAGCGTTGAGTTACAG
TACGGTCGTTTCCGGTCGA -> ACGGTCGTTTCCGGTCGAG
GGGATCGCGGCGGACAAGT -> GGATCGCGGCGGACAAGTA
GAGACCCATAGCTTCATAA -> AGACCCATAGCTTCATAAA, AGACCCATAGCTTCATAAG
ATGTAAGCCGTCGTTCTGC -> TGTAAGCCGTCGTTCTGCC
GCCGTCGTTCTGCCGTGGG -> CCGTCGTTCTGCCGTGGGC
ATCGCGGCGGACAAGTATC -> TCGCGGCGGACAAGTATCC
AACCCAGATACGGTTCATA -> ACCCAGATACGGTTCATAC
TAGCTTCATAAAACCTCCA -> AGCTTCATAAAACCTCCAG
ACTTGCTACTATGAGAGCA -> CTTGCTACTATGAGAGCAG
TGGGGAACATGCTTGCTGT -> GGGGAACATGCTTGCTGTC
GCCGTGGGCGAGAGTTTCT -> CCGTGGGCGAGAGTTTCTC
TTAGGCTATGATTGAGCGT -> TAGGCTATGATTGAGCGTT
TTACAGCCAATTGCTAACG -> TACAGCCAATTGCTAACGG
AGCTTCATTTCGAAAAGAA -> GCTTCATTTCGAAAAGAAC
ATGAGGCATTCTATGCCCG -> TGAGGCATTCTATGCCCGC
CTGTAAAGACTCGGTCTGG -> TGTAAAGACTCGGTCTGGA
TTTCGTTACGGTCGTTTCC -> TTCGTTACGGTCGTTTCCG
CGTTGAGTTACAGCCAATT -> GTTGAGTTACAGCCAATTG
GTACCTAGTTGTCCGCTTT -> TACCTAGTTGTCCGCTTTT
ACTTGTTTCGCCGATCGAT -> CTTGTTTCGCCGATCGATG
GCTTAGCGTAGCAACTGCG -> CTTAGCGTAGCAACTGCGG
ATAGATGCCGTTAATAGCG -> TAGATGCCGTTAATAGCGC
CGTCGTTCTGCCGTGGGCG -> GTCGTTCTGCCGTGGGCGA
GTGGTGAGAAATACGTTAC -> TGGTGAGAAATACGTTACG
GACTTAGAAGACGCTAGCT -> ACTTAGAAGACGCTAGCTG
ATAGCTTCATAAGACGGCG -> TAGCTTCATAAGACGGCGA
GTGCCGTATCATGGGACCG -> TGCCGTATCATGGGACCGG
TTGCTGTCCGCGCTACTCG -> TGCTGTCCGCGCTACTCGA
TTGAAGTAGGGCTCCACCA -> TGAAGTAGGGCTCCACCAC
TGTTGTCCGGCGCGGACTA -> GTTGTCCGGCGCGGACTAT
GGGCCTTGACGCTGTCCGG -> GGCCTTGACGCTGTCCGGG
GTCTCGGCACGCACATTAA -> TCTCGGCACGCACATTAAG
GCTTCATAAGACGGCGATG -> CTTCATAAGACGGCGATGC
TTTTCCCTCATTGTGAGTC -> TTTCCCTCATTGTGAGTCT
CTCTGCACTGCCCTAAACC -> TCTGCACTGCCCTAAACCT
ACTCCTTCCCGGGGTCCCG -> CTCCTTCCCGGGGTCCCGG
AGGCTATGATTGAGCGTTT -> GGCTATGATTGAGCGTTTG
CGGCTGCTATTTGTGCCCG -> GGCTGCTATTTGTGCCCGC
CCGTTAATAGCGCAGTCCA -> CGTTAATAGCGCAGTCCAC
CGAGACCAAACTGTGGGAC -> GAGACCAAACTGTGGGACT
GACTTGGGCCTTGACGCTG -> ACTTGGGCCTTGACGCTGT
GTTGCCCACATTGCACGTC -> TTGCCCACATTGCACGTCT
ACTCCACAGGTGCCAGCTA -> CTCCACAGGTGCCAGCTAA
TTCAGGAATGAGGCATTCC -> TCAGGAATGAGGCATTCCG
ACGCTAGTAAGGAGCTTCG -> CGCTAGTAAGGAGCTTCGA
TCGAACTGCTCTGTTACTT -> CGAACTGCTCTGTTACTTC
GAAGAAGGAGACTTCACCA -> AAGAAGGAGACTTCACCAG
TACTCTGACTTAGTATGTG -> ACTCTGACTTAGTATGTGG
TCCCCGTGTGTTGTCCGGC -> CCCCGTGTGTTGTCCGGCG
CGCCGATCGATGGCCAATT -> GCCGATCGATGGCCAATTA
GCTGAGGAACCACTACCCC -> CTGAGGAACCACTACCCCA
GTGAGAAATACGTTACGTT -> TGAGAAATACGTTACGTTA
TCGTTCTGCCGTGGGCGAG -> CGTTCTGCCGTGGGCGAGA
ACTGTGGGACTTGGGCCTT -> CTGTGGGACTTGGGCCTTG
CGAAAAGAACGACTCAAGC -> GAAAAGAACGACTCAAGCG
CGGGTTCTAAGCTTAGCGT -> GGGTTCTAAGCTTAGCGTA
TGCTATGACGCCCTCAATG -> GCTATGACGCCCTCAATGT
GTTAATAGCGCAGTCCACA -> TTAATAGCGCAGTCCACAG
CGGCACTAAGGAGACCCAT -> GGCACTAAGGAGACCCATA
TAGCTTCATTTCGAAAAGA -> AGCTTCATTTCGAAAAGAA
AGCTAGTTGCCCACATTGC -> GCTAGTTGCCCACATTGCA
GCAACGACACCCGTAGTCG -> CAACGACACCCGTAGTCGC
TAGTAAGGAGCTTCGAACT -> AGTAAGGAGCTTCGAACTG
GCCCGCTTGCCCTCCCTCA -> CCCGCTTGCCCTCCCTCAT
CTATTAACAGGACAGCGTT -> TATTAACAGGACAGCGTTG
GTCCTTATTTTGGCAGGAA -> TCCTTATTTTGGCAGGAAC
GGTTACAGCCCTCCCCCGT -> GTTACAGCCCTCCCCCGTC
ACTTGGGCCTTGACGCTGT -> CTTGGGCCTTGACGCTGTC
ATTAAAACCGTGCACCAGA -> TTAAAACCGTGCACCAGAC
AGTCCACAGGGAGGAGGGG -> GTCCACAGGGAGGAGGGGA
GACGGTAGCTCAGGGCTTG -> ACGGTAGCTCAGGGCTTGT
GAGGCATTCGTACGGCACT -> AGGCATTCGTACGGCACTA
CTGTCCGGGAAACTGACTG -> TGTCCGGGAAACTGACTGG
AGGACACCCGCACCAACCA -> GGACACCCGCACCAACCAT
ACAAGGGGATCGCGGCGGA -> CAAGGGGATCGCGGCGGAC
GTATGTCATTGACCTCCGT -> TATGTCATTGACCTCCGTT
CCGCTTTTAGCCACTAGGC -> CGCTTTTAGCCACTAGGCC
TATCAGATACTCCTTCCCG -> ATCAGATACTCCTTCCCGG
TTAAGGACGGCGCAACAGA -> TAAGGACGGCGCAACAGAC
GGCGAGAGTTTCTCCTGTT -> GCGAGAGTTTCTCCTGTTA
CAGATACTCCTTCCCGGGG -> AGATACTCCTTCCCGGGGT
CCTCTGCCAAGGAGACCCA -> CTCTGCCAAGGAGACCCAT
CCGTCTTTAGGACACCCGC -> CGTCTTTAGGACACCCGCA
TAATCCCACGAGATCCTGA -> AATCCCACGAGATCCTGAG
ACCAACCATAGGAAGGACC -> CCAACCATAGGAAGGACCG
GCCGTATCATGGGACCGGT -> CCGTATCATGGGACCGGTA
GGCACGCACATTAAGGACG -> GCACGCACATTAAGGACGG
AGAGTTGTCTATATTGAAG -> GAGTTGTCTATATTGAAGT
CGTATCATGGGACCGGTAT -> GTATCATGGGACCGGTATC
TTGCTATGACGCCCTCAAT -> TGCTATGACGCCCTCAATG
ATTGAAGTAGGGCTCCACC -> TTGAAGTAGGGCTCCACCA
CCGACTGGTGCACTAACTG -> CGACTGGTGCACTAACTGT
GTGCTCCTTTTAGCTACAA -> TGCTCCTTTTAGCTACAAT
TAACATGGGGAACATGCTT -> AACATGGGGAACATGCTTG
TACAGTTTCTATAATACCA -> ACAGTTTCTATAATACCAT
CATGCTTGCTGTCCGCGCT -> ATGCTTGCTGTCCGCGCTA
GATTAAGAGTCTGATTTAG -> ATTAAGAGTCTGATTTAGA
GGGTACAGTTTCTATAATA -> GGTACAGTTTCTATAATAC
TCATGGGACCGGTATCCCT -> CATGGGACCGGTATCCCTA
TTGCTAACGGGACCCCGTC -> TGCTAACGGGACCCCGTCC
TCCTGTTAGCGTTAGCTAG -> CCTGTTAGCGTTAGCTAGT
CGCCTGACGCCTCGCGGAG -> GCCTGACGCCTCGCGGAGC
TAAGATCACGCACCTGCAC -> AAGATCACGCACCTGCACT
GCTCCGGAACGCGGTGAGT -> CTCCGGAACGCGGTGAGTT
ATGTTAGGCTATGATTGAG -> TGTTAGGCTATGATTGAGC
CGTTGGCTCAGATACGAGC -> GTTGGCTCAGATACGAGCG
GATGGCCAATTACGTGGAG -> ATGGCCAATTACGTGGAGG
CTTGACTCTCATCAGGGTA -> TTGACTCTCATCAGGGTAC
GGCCAATTACGTGGAGGCT -> GCCAATTACGTGGAGGCTG
CGCGGTGAGTTCACTATGC -> GCGGTGAGTTCACTATGCT
AGTTCAGGATTTAGAGCGG -> GTTCAGGATTTAGAGCGGT
CCCGTAGTCGCGGGACTGG -> CCGTAGTCGCGGGACTGGA
GCGGACTATTAACAGGACA -> CGGACTATTAACAGGACAG
TTGACCGACTGGTGCACTA -> TGACCGACTGGTGCACTAA
TCGCGGAGCCCCGACGAGT -> CGCGGAGCCCCGACGAGTG
GGACTTGGGCCTTGACGCT -> GACTTGGGCCTTGACGCTG
TTCAGGATTTAGAGCGGTT -> TCAGGATTTAGAGCGGTTC
GAGTAAAAGAGTAGCTCAT -> AGTAAAAGAGTAGCTCATT
GTCTTACTTGTTTCGCCGA -> TCTTACTTGTTTCGCCGAT
AGGCGTCTTGACTCTCATC -> GGCGTCTTGACTCTCATCA
ACTATGAGAGCAGTCTTAC -> CTATGAGAGCAGTCTTACT
GCCCACTCCGCTGAGGAAC -> CCCACTCCGCTGAGGAACC
GGCGTCATCGTAGTCGCCA -> GCGTCATCGTAGTCGCCAA
AAATATGGTATAGATGCCG -> AATATGGTATAGATGCCGT
GTCTTTGAATAGCGTTGAG -> TCTTTGAATAGCGTTGAGT
ACTGGATTAAGAGTCTGAT -> CTGGATTAAGAGTCTGATT
CGGGACCCCGTCCTTATTT -> GGGACCCCGTCCTTATTTT
TGTTGGATTAAAACCGTGC -> GTTGGATTAAAACCGTGCA
GAGAGCAGTCTTACTTGTT -> AGAGCAGTCTTACTTGTTT
ACAGCGCAAGCCCGGCAAT -> CAGCGCAAGCCCGGCAATT
CCGACGAGTGTTAGACGAC -> CGACGAGTGTTAGACGACC
TATGAGAGCAGTCTTACTT -> ATGAGAGCAGTCTTACTTG
ATCACGCACCTGCACTGCA -> TCACGCACCTGCACTGCAA
TGGGACCGGTATCCCTACG -> GGGACCGGTATCCCTACGA
GCTCACCGTGCCGTATCAT -> CTCACCGTGCCGTATCATG
AAGCTTAGCGTAGCAACTG -> AGCTTAGCGTAGCAACTGC
CCACAGGTGCCAGCTAACT -> CACAGGTGCCAGCTAACTG
TCATCGTAGTCGCCAAATA -> CATCGTAGTCGCCAAATAT
TCAGATACGAGCGCCTGAC -> CAGATACGAGCGCCTGACG
TGGATAAGATCACGCACCT -> GGATAAGATCACGCACCTG
CTCAATGTCAAGGCGGTCT -> TCAATGTCAAGGCGGTCTG
AGGGGACTTGACCGACTGG -> GGGGACTTGACCGACTGGT
TGGATTAAAACCGTGCACC -> GGATTAAAACCGTGCACCA
TTCTAAGCTTAGCGTAGCA -> TCTAAGCTTAGCGTAGCAA
GAGGCTGCGTTGTATGTCA -> AGGCTGCGTTGTATGTCAT
AGTAACATGGGGAACATGC -> GTAACATGGGGAACATGCT
CTCGGTCTGGACGTTGCCT -> TCGGTCTGGACGTTGCCTT
GACGGCGATGCGAAGTTAT -> ACGGCGATGCGAAGTTATC
GCGAAGTTATCAGATACTC -> CGAAGTTATCAGATACTCC
GACAACCGACGCTAATGCT -> ACAACCGACGCTAATGCTA
TAGCTTCATTGTGCGGTGA -> AGCTTCATTGTGCGGTGAC
GCTCCTTTTAGCTACAATT -> CTCCTTTTAGCTACAATTG
ACCCATAGCTTCATAAGAC -> CCCATAGCTTCATAAGACG
ACGGACCCCGCGATTTACT -> CGGACCCCGCGATTTACTT
CAAGGGGATCGCGGCGGAC -> AAGGGGATCGCGGCGGACA
CTCACCGTGCCGTATCATG -> TCACCGTGCCGTATCATGG
GAGAGTTTCTCCTGTTAGC -> AGAGTTTCTCCTGTTAGCG
GGCGAAGAAGGAGACTTCA -> GCGAAGAAGGAGACTTCAC
GCAGGAACCCAGATACGGT -> CAGGAACCCAGATACGGTT
TGACTTAGTATGTGGTACT -> GACTTAGTATGTGGTACTC
TGCCAATAAAATTACTCTG -> GCCAATAAAATTACTCTGA
TAATGCTATTTGTATATAG -> AATGCTATTTGTATATAGG
GATCGATGGCCAATTACGT -> ATCGATGGCCAATTACGTG
TAAAACCTCCAGACGGGGC -> AAAACCTCCAGACGGGGCT
TTAGCTAGTTGCCCACATT -> TAGCTAGTTGCCCACATTG
CATTTCGAAAAGAACGACT -> ATTTCGAAAAGAACGACTC
CAGATACGAGCGCCTGACG -> AGATACGAGCGCCTGACGC
AACAAGGGGATCGCGGCGG -> ACAAGGGGATCGCGGCGGA
GGACTGGATTAAGAGTCTG -> GACTGGATTAAGAGTCTGA
TTAAGAGTCTGATTTAGAT -> TAAGAGTCTGATTTAGATG
CGACGCTATGTTAGGCTAT -> GACGCTATGTTAGGCTATG
TATGTCATTGACCTCCGTT -> ATGTCATTGACCTCCGTTC
AAGTGAAGGCGAAGAAGGA -> AGTGAAGGCGAAGAAGGAG
CTCCGGAACGCGGTGAGTT -> TCCGGAACGCGGTGAGTTC
CAACTGCGGCATTAGAGAC -> AACTGCGGCATTAGAGACT
TCCACAGGTGCCAGCTAAC -> CCACAGGTGCCAGCTAACT
GGTACCTAGTTGTCCGCTT -> GTACCTAGTTGTCCGCTTT
GGGAAACTGACTGGATAAG -> GGAAACTGACTGGATAAGA
GCTGCTATTTGTGCCCGCT -> CTGCTATTTGTGCCCGCTT
TGCAACGACACCCGTAGTC -> GCAACGACACCCGTAGTCG
CTAACGGGACCCCGTCCTT -> TAACGGGACCCCGTCCTTA
GCGCGGACTATTAACAGGA -> CGCGGACTATTAACAGGAC
TTCAGGAATGAGGCATTCA -> TCAGGAATGAGGCATTCAC
ATATTGCTATGACGCCCTC -> TATTGCTATGACGCCCTCA
GACCCCGCGATTTACTTCA -> ACCCCGCGATTTACTTCAT
CCCATAGCTTCATAAAACC -> CCATAGCTTCATAAAACCT
CGGTTACAGCCCTCCCCCG -> GGTTACAGCCCTCCCCCGT
TTATTAGGTATTTCAGGAA -> TATTAGGTATTTCAGGAAT
GGGACCGGTATCCCTACGA -> GGACCGGTATCCCTACGAT
GGTCGAGACCAAACTGTGG -> GTCGAGACCAAACTGTGGG
CCCACGAGATCCTGAGCCC -> CCACGAGATCCTGAGCCCA
AAGAAAAGTGATAGAGTAG -> AGAAAAGTGATAGAGTAGA
TAATAGCGCAGTCCACAGG -> AATAGCGCAGTCCACAGGG
ACTCTGACTTAGTATGTGG -> CTCTGACTTAGTATGTGGT
ATACCATTGGATACTTAGT -> TACCATTGGATACTTAGTT
GTGAGTCTTTGAATAGCGT -> TGAGTCTTTGAATAGCGTT
TAACTGTAAAGACTCGGTC -> AACTGTAAAGACTCGGTCT
ACTGGATAAGATCACGCAC -> CTGGATAAGATCACGCACC
AATAAAATTACTCTGACTT -> ATAAAATTACTCTGACTTA
CTCATCAGGGTACAGTTTC -> TCATCAGGGTACAGTTTCT
CACGTCTCGGCACGCACAT -> ACGTCTCGGCACGCACATT
GGATACTTAGTTCCTGGAA -> GATACTTAGTTCCTGGAAC
TGCGGCATTAGAGACTTAG -> GCGGCATTAGAGACTTAGA
GGAATGAGGCATTCGTACG -> GAATGAGGCATTCGTACGG
AGAGTAAAAGAGTAGCTCA -> GAGTAAAAGAGTAGCTCAT
ACGCTATGTTAGGCTATGA -> CGCTATGTTAGGCTATGAT
GTTGTCTATATTGAAGTAG -> TTGTCTATATTGAAGTAGG
GCTTCGCCGACGAGGCTGC -> CTTCGCCGACGAGGCTGCG
GTAGGGCTCCACCACATGG -> TAGGGCTCCACCACATGGT
TACAGCGCAAGCCCGGCAA -> ACAGCGCAAGCCCGGCAAT
TTTGGCAGGAACCCAGATA -> TTGGCAGGAACCCAGATAC
CACTATGCTACATAAGCTT -> ACTATGCTACATAAGCTTC
GAGTCTGATTTAGATGACG -> AGTCTGATTTAGATGACGG
TAGTTCCTGGAACAAGGGG -> AGTTCCTGGAACAAGGGGA
TTTCCCCGTGTGTTGTCCG -> TTCCCCGTGTGTTGTCCGG
TGACTGGATAAGATCACGC -> GACTGGATAAGATCACGCA
ACGGGACCCCGTCCTTATT -> CGGGACCCCGTCCTTATTT
AGGAAGGACCGCGCACAGA -> GGAAGGACCGCGCACAGAA
TTCGCCGATCGATGGCCAA -> TCGCCGATCGATGGCCAAT
CAATAAAATTACTCTGACT -> AATAAAATTACTCTGACTT
GTCCGCTTTTAGCCACTAG -> TCCGCTTTTAGCCACTAGG
TGCACCAGACGACGCTATG -> GCACCAGACGACGCTATGT
CACTAACTGTAAAGACTCG -> ACTAACTGTAAAGACTCGG
TCGCCAAATATGGTATAGA -> CGCCAAATATGGTATAGAT
AGCTTCGCCGACGAGGCTG -> GCTTCGCCGACGAGGCTGC
CGCTGTCCGGGAAACTGAC -> GCTGTCCGGGAAACTGACT
ACGTTACGTTATACGGTGG -> CGTTACGTTATACGGTGGT
ACCAAGATTTTTCCCTCAT -> CCAAGATTTTTCCCTCATT
CGTTAATAGCGCAGTCCAC -> GTTAATAGCGCAGTCCACA
GGCTTGTTAGTTGCTACAC -> GCTTGTTAGTTGCTACACT
GCCTCGCGGAGCCCCGACG -> CCTCGCGGAGCCCCGACGA
CTATGCCCGCAAAGGAGAC -> TATGCCCGCAAAGGAGACC
CCGGTTACAGCCCTCCCCC -> CGGTTACAGCCCTCCCCCG
CCATAGCTTCATTGTGCGG -> CATAGCTTCATTGTGCGGT
TTTCCAAATGAGGTCCGCG -> TTCCAAATGAGGTCCGCGT
CTCCTGTTAGCGTTAGCTA -> TCCTGTTAGCGTTAGCTAG
GCATTCCGCCTCTGCCAAG -> CATTCCGCCTCTGCCAAGG
AAGACTTGCTACTATGAGA -> AGACTTGCTACTATGAGAG
CGGTCGAGACCAAACTGTG -> GGTCGAGACCAAACTGTGG
CATTAAGGACGGCGCAACA -> ATTAAGGACGGCGCAACAG
TTTTTCCCTCATTGTGAGT -> TTTTCCCTCATTGTGAGTC
ATCGTAGTCGCCAAATATG -> TCGTAGTCGCCAAATATGG
CGAGGCTGCGTTGTATGTC -> GAGGCTGCGTTGTATGTCA
CTCCTTTTAGCTACAATTG -> TCCTTTTAGCTACAATTGA
CACCGTGCCGTATCATGGG -> ACCGTGCCGTATCATGGGA
CCGGAACGCGGTGAGTTCA -> CGGAACGCGGTGAGTTCAC
TTAGTTGCTACACTCTCGG -> TAGTTGCTACACTCTCGGG
GGAGGCTGTCGCTCACCGT -> GAGGCTGTCGCTCACCGTG
GGAACATGCTTGCTGTCCG -> GAACATGCTTGCTGTCCGC
CCTGGAACAAGGGGATCGC -> CTGGAACAAGGGGATCGCG
TTTCTATAATACCATTGGA -> TTCTATAATACCATTGGAT
GACTCTCATCAGGGTACAG -> ACTCTCATCAGGGTACAGT
AACAGGACAGCGTTGGCTC -> ACAGGACAGCGTTGGCTCA
CCGCAAAGGAGACCCATAG -> CGCAAAGGAGACCCATAGC
CACAGAACATGAAAAGGGG -> ACAGAACATGAAAAGGGGA
ACGGCGCAACAGACCAAGA -> CGGCGCAACAGACCAAGAT
GAGACCCATAGCTTCATTG -> AGACCCATAGCTTCATTGT
TGAGGTCCGCGTAGGTTTA -> GAGGTCCGCGTAGGTTTAT
CTAACTGTAAAGACTCGGT -> TAACTGTAAAGACTCGGTC
CGTAGGTTTATGGATCTCA -> GTAGGTTTATGGATCTCAA
TGAAGGCGAAGAAGGAGAC -> GAAGGCGAAGAAGGAGACT
GTCTTTAGGACACCCGCAC -> TCTTTAGGACACCCGCACC
AACGACACCCGTAGTCGCG -> ACGACACCCGTAGTCGCGG
GCTGTCCGGGAAACTGACT -> CTGTCCGGGAAACTGACTG
GTACGGCACTAAGGAGACC -> TACGGCACTAAGGAGACCC
AATGAGGCATTCGTACGGC -> ATGAGGCATTCGTACGGCA
TCCGGGAAACTGACTGGAT -> CCGGGAAACTGACTGGATA
ATGGGACCGGTATCCCTAC -> TGGGACCGGTATCCCTACG
ATTCCGCCTCTGCCAAGGA -> TTCCGCCTCTGCCAAGGAG
AAAACCGTGCACCAGACGA -> AAACCGTGCACCAGACGAC
ATTGGATACTTAGTTCCTG -> TTGGATACTTAGTTCCTGG
TTTGACGGTAGCTCAGGGC -> TTGACGGTAGCTCAGGGCT
GCGGCATTAGAGACTTAGA -> CGGCATTAGAGACTTAGAA
CATTGTGCGGTGACTCTGC -> ATTGTGCGGTGACTCTGCA
GCGGTCTGCTGATGTATTA -> CGGTCTGCTGATGTATTAT
AGTTTCTATAATACCATTG -> GTTTCTATAATACCATTGG
GAAGACGCTAGCTGCAACG -> AAGACGCTAGCTGCAACGA
CGTAGTCGCGGGACTGGAT -> GTAGTCGCGGGACTGGATT
CTATAATACCATTGGATAC -> TATAATACCATTGGATACT
ACAGCGTTGGCTCAGATAC -> CAGCGTTGGCTCAGATACG
TCAGACCGAGTAACATGGG -> CAGACCGAGTAACATGGGG
ATTTTTCATTTGTTGGATT -> TTTTTCATTTGTTGGATTA
AGAGCAGTCTTACTTGTTT -> GAGCAGTCTTACTTGTTTC
CCACAGGGAGGAGGGGAGT -> CACAGGGAGGAGGGGAGTT
TGGTCATCCAGGGAGGACC -> GGTCATCCAGGGAGGACCT
TCTTTAGGACACCCGCACC -> CTTTAGGACACCCGCACCA
AGGCTGCGTTGTATGTCAT -> GGCTGCGTTGTATGTCATT
CCTCAATGTCAAGGCGGTC -> CTCAATGTCAAGGCGGTCT
GTATCATGGGACCGGTATC -> TATCATGGGACCGGTATCC
GAACTGCTCTGTTACTTCA -> AACTGCTCTGTTACTTCAG
AAAGTGATAGAGTAGAGTA -> AAGTGATAGAGTAGAGTAA
TTTAGATGACGGTGCCCTA -> TTAGATGACGGTGCCCTAC
TGTTTCGCCGATCGATGGC -> GTTTCGCCGATCGATGGCC
TTTTCCCCGTGTGTTGTCC -> TTTCCCCGTGTGTTGTCCG
AGGAATGAGGCATTCCGCC -> GGAATGAGGCATTCCGCCT
TTCCTGGAACAAGGGGATC -> TCCTGGAACAAGGGGATCG
TTCACCCTTCCGAGAGTTG -> TCACCCTTCCGAGAGTTGT
GGCAACTCTTGGGTTCAGG -> GCAACTCTTGGGTTCAGGA
ACCACTACCCCAAATATTC -> CCACTACCCCAAATATTCA
ACATGAAAAGGGGACTTGA -> CATGAAAAGGGGACTTGAC
GTGCCCGCTTGCCCTCCCT -> TGCCCGCTTGCCCTCCCTC
AGCCACTAGGCCTCTTGCT -> GCCACTAGGCCTCTTGCTC
AGGAACCACTACCCCAAAT -> GGAACCACTACCCCAAATA
TAGCTAGTTGCCCACATTG -> AGCTAGTTGCCCACATTGC
TATTTGTGCCCGCTTGCCC -> ATTTGTGCCCGCTTGCCCT
TCGAAAAGAACGACTCAAG -> CGAAAAGAACGACTCAAGC
CCACATTGCACGTCTCGGC -> CACATTGCACGTCTCGGCA
TAGAAGACGCTAGCTGCAA -> AGAAGACGCTAGCTGCAAC
ATATGGTATAGATGCCGTT -> TATGGTATAGATGCCGTTA
ACCATTGGATACTTAGTTC -> CCATTGGATACTTAGTTCC
GCGGTGACTCTGCACTGCC -> CGGTGACTCTGCACTGCCC
CCAAATATTCAGGAATGAG -> CAAATATTCAGGAATGAGG
TGTGGGACTTGGGCCTTGA -> GTGGGACTTGGGCCTTGAC
CATGAAAAGGGGACTTGAC -> ATGAAAAGGGGACTTGACC
GGGACTTGGGCCTTGACGC -> GGACTTGGGCCTTGACGCT
ACTCGGTTCACCCTTCCGA -> CTCGGTTCACCCTTCCGAG
ACAGCCCTCCCCCGTCTTT -> CAGCCCTCCCCCGTCTTTA
CGAAGAAGGAGACTTCACC -> GAAGAAGGAGACTTCACCA
CCCGCGATTTACTTCATGG -> CCGCGATTTACTTCATGGA
GACTTGCTACTATGAGAGC -> ACTTGCTACTATGAGAGCA
GATGATGTAAGCCGTCGTT -> ATGATGTAAGCCGTCGTTC
GTATTATTAGGTATTTCAG -> TATTATTAGGTATTTCAGG
AATGTCAAGGCGGTCTGCT -> ATGTCAAGGCGGTCTGCTG
TCACAGTGGCCGAGGACTC -> CACAGTGGCCGAGGACTCC
AACAGACCAAGATTTTTCC -> ACAGACCAAGATTTTTCCC
TGAGCGCGTCCAACGGACC -> GAGCGCGTCCAACGGACCC
AATTACGTGGAGGCTGTCG -> ATTACGTGGAGGCTGTCGC
TAGGGCTCCACCACATGGT -> AGGGCTCCACCACATGGTC
CGTCCTTATTTTGGCAGGA -> GTCCTTATTTTGGCAGGAA
TTTTAGCCACTAGGCCTCT -> TTTAGCCACTAGGCCTCTT
GGATAAGATCACGCACCTG -> GATAAGATCACGCACCTGC
GCGATGCGAAGTTATCAGA -> CGATGCGAAGTTATCAGAT
ACGGTAGCTCAGGGCTTGT -> CGGTAGCTCAGGGCTTGTT
ACCGGCGTCATCGTAGTCG -> CCGGCGTCATCGTAGTCGC
CTTCGAACTGCTCTGTTAC -> TTCGAACTGCTCTGTTACT
TCCGCTGAGGAACCACTAC -> CCGCTGAGGAACCACTACC
GACCAAGATTTTTCCCTCA -> ACCAAGATTTTTCCCTCAT
GGTATTTCAGGAATGAGGC -> GTATTTCAGGAATGAGGCA
GGAACAAGGGGATCGCGGC -> GAACAAGGGGATCGCGGCG
CTATGAGAGCAGTCTTACT -> TATGAGAGCAGTCTTACTT
CTTGCCCTCCCTCATCATC -> TTGCCCTCCCTCATCATCC
CTGTTACTTCAGGAATGAG -> TGTTACTTCAGGAATGAGG
AGCTTCGAACTGCTCTGTT -> GCTTCGAACTGCTCTGTTA
GCAACAGACCAAGATTTTT -> CAACAGACCAAGATTTTTC
AGGGGAGTTCAGGATTTAG -> GGGGAGTTCAGGATTTAGA
CACCACATGGTCATCCAGG -> ACCACATGGTCATCCAGGG
GACACCCGTAGTCGCGGGA -> ACACCCGTAGTCGCGGGAC
CTTGCTGTCCGCGCTACTC -> TTGCTGTCCGCGCTACTCG
TCCCCCGTCTTTAGGACAC -> CCCCCGTCTTTAGGACACC
TGTCCGCGCTACTCGACAA -> GTCCGCGCTACTCGACAAC
CACTGCAACCGGCGTCATC -> ACTGCAACCGGCGTCATCG
AAACCTCCAGACGGGGCTC -> AACCTCCAGACGGGGCTCC
TTTACTTCATGGATCTCCA -> TTACTTCATGGATCTCCAT
CTACATAAGCTTCGCCGAC -> TACATAAGCTTCGCCGACG
AAAAGAGTAGCTCATTTAC -> AAAGAGTAGCTCATTTACT
GGCGGTCTGCTGATGTATT -> GCGGTCTGCTGATGTATTA
AGAGTAGAGTAAAAGAGTA -> GAGTAGAGTAAAAGAGTAG
CAGGACAGCGTTGGCTCAG -> AGGACAGCGTTGGCTCAGA
TTACTCTGACTTAGTATGT -> TACTCTGACTTAGTATGTG
AACCACTACCCCAAATATT -> ACCACTACCCCAAATATTC
GGCCTTGACGCTGTCCGGG -> GCCTTGACGCTGTCCGGGA
GACCGACTGGTGCACTAAC -> ACCGACTGGTGCACTAACT
CGAGTTACGCTAGTAAGGA -> GAGTTACGCTAGTAAGGAG
TGGCCGAGGACTCCACAGG -> GGCCGAGGACTCCACAGGT
TTCATAAAACCTCCAGACG -> TCATAAAACCTCCAGACGG
ACGATAGAGGATCACAGTG -> CGATAGAGGATCACAGTGG
TGGACGTTGCCTTTCCAAA -> GGACGTTGCCTTTCCAAAT
ACGTCGATGATGTAAGCCG -> CGTCGATGATGTAAGCCGT
GTTCAGGAATGAGGCATTC -> TTCAGGAATGAGGCATTCG
AGATACGGTTCATACCTTT -> GATACGGTTCATACCTTTA
TTAGGTATTTCAGGAATGA -> TAGGTATTTCAGGAATGAG
ATAGGAAGGACCGCGCACA -> TAGGAAGGACCGCGCACAG
ATTTGTGCCCGCTTGCCCT -> TTTGTGCCCGCTTGCCCTC
GTTTCCGGTCGAGACCAAA -> TTTCCGGTCGAGACCAAAC
GTCGCCAAATATGGTATAG -> TCGCCAAATATGGTATAGA
CCGGTCGAGACCAAACTGT -> CGGTCGAGACCAAACTGTG
TTGGATACTTAGTTCCTGG -> TGGATACTTAGTTCCTGGA
ATTGCACGTCTCGGCACGC -> TTGCACGTCTCGGCACGCA
AACCGTGCACCAGACGACG -> ACCGTGCACCAGACGACGC
GCTATGACGCCCTCAATGT -> CTATGACGCCCTCAATGTC
CAGTCCACAGGGAGGAGGG -> AGTCCACAGGGAGGAGGGG
CTCCAGACGGGGCTCCGGA -> TCCAGACGGGGCTCCGGAA
CGAGATCCTGAGCCCACTC -> GAGATCCTGAGCCCACTCC
CTCTTGCTCGTACTTGAGC -> TCTTGCTCGTACTTGAGCG
CTGAGCCCACTCCGCTGAG -> TGAGCCCACTCCGCTGAGG
CTGCTGATGTATTATTAGG -> TGCTGATGTATTATTAGGT
AAGGGGACTTGACCGACTG -> AGGGGACTTGACCGACTGG
GAGTGTTAGACGACCATTA -> AGTGTTAGACGACCATTAA
AGGAGCTTCGAACTGCTCT -> GGAGCTTCGAACTGCTCTG
AGAGGATCACAGTGGCCGA -> GAGGATCACAGTGGCCGAG
AGAACGACTCAAGCGTATT -> GAACGACTCAAGCGTATTT
CCTCCCTCATCATCCGAAT -> CTCCCTCATCATCCGAATA
GGGAGGACCTACTCACTTT -> GGAGGACCTACTCACTTTT
CCTCTTGCTCGTACTTGAG -> CTCTTGCTCGTACTTGAGC
TGGAGGCTGTCGCTCACCG -> GGAGGCTGTCGCTCACCGT
CTGTCTCTGTCCCTTCACT -> TGTCTCTGTCCCTTCACTG
CGTTCAGACCGAGTAACAT -> GTTCAGACCGAGTAACATG
ATGCCGTTAATAGCGCAGT -> TGCCGTTAATAGCGCAGTC
AAACTGTGGGACTTGGGCC -> AACTGTGGGACTTGGGCCT
CCGGCAATTCAAGTGAAGG -> CGGCAATTCAAGTGAAGGC
AGCCCCGACGAGTGTTAGA -> GCCCCGACGAGTGTTAGAC
ATGCTTGCTGTCCGCGCTA -> TGCTTGCTGTCCGCGCTAC
CTGTGGGACTTGGGCCTTG -> TGTGGGACTTGGGCCTTGA
CCTTTTAGCTACAATTGAC -> CTTTTAGCTACAATTGACG
TGGATCTCAAGACTTGCTA -> GGATCTCAAGACTTGCTAC
AGGTCCGCGTAGGTTTATG -> GGTCCGCGTAGGTTTATGG
TGGTACTCCTTACAGCGCA -> GGTACTCCTTACAGCGCAA
GCCCTCCCTCATCATCCGA -> CCCTCCCTCATCATCCGAA
CGGTGCCCTACGTCGATGA -> GGTGCCCTACGTCGATGAT
GAACGACTCAAGCGTATTT -> AACGACTCAAGCGTATTTT
CTCCCCCGTCTTTAGGACA -> TCCCCCGTCTTTAGGACAC
GTCTGGACGTTGCCTTTCC -> TCTGGACGTTGCCTTTCCA
TTGACTCTCATCAGGGTAC -> TGACTCTCATCAGGGTACA
TGGTGCACTAACTGTAAAG -> GGTGCACTAACTGTAAAGA
CAGCGCAAGCCCGGCAATT -> AGCGCAAGCCCGGCAATTC
CGTCGATGATGTAAGCCGT -> GTCGATGATGTAAGCCGTC
ATTTCGAAAAGAACGACTC -> TTTCGAAAAGAACGACTCA
GACTGGATAAGATCACGCA -> ACTGGATAAGATCACGCAC
TGTCCGGGAAACTGACTGG -> GTCCGGGAAACTGACTGGA
GGAGGGGAGTTCAGGATTT -> GAGGGGAGTTCAGGATTTA
GTGCCAGCTAACTGACGAG -> TGCCAGCTAACTGACGAGT
GGATTAAGAGTCTGATTTA -> GATTAAGAGTCTGATTTAG
GTCGATGATGTAAGCCGTC -> TCGATGATGTAAGCCGTCG
CCCCGTCTTTAGGACACCC -> CCCGTCTTTAGGACACCCG
GGAAGGACCGCGCACAGAA -> GAAGGACCGCGCACAGAAC
CTCGGGTTCTAAGCTTAGC -> TCGGGTTCTAAGCTTAGCG
TCCTTTTAGCTACAATTGA -> CCTTTTAGCTACAATTGAC
GTATCCATCGGCTGCTATT -> TATCCATCGGCTGCTATTT
TCGGTTCACCCTTCCGAGA -> CGGTTCACCCTTCCGAGAG
GCGGAGCCCCGACGAGTGT -> CGGAGCCCCGACGAGTGTT
CCCGCACCAACCATAGGAA -> CCGCACCAACCATAGGAAG
GACTTAGTATGTGGTACTC -> ACTTAGTATGTGGTACTCC
CCTGTTAGCGTTAGCTAGT -> CTGTTAGCGTTAGCTAGTT
CAAATATGGTATAGATGCC -> AAATATGGTATAGATGCCG
TAGCTTCATAAGACGGCGA -> AGCTTCATAAGACGGCGAT
ATAGAGTAGAGTAAAAGAG -> TAGAGTAGAGTAAAAGAGT
CACGAGTTATTAAGGAGAC -> ACGAGTTATTAAGGAGACC
CAAGGAGACCCATAGCTTC -> AAGGAGACCCATAGCTTCA
AGATGCCGTTAATAGCGCA -> GATGCCGTTAATAGCGCAG
CCCTTCACTGCCGGTGCTC -> CCTTCACTGCCGGTGCTCC
ACGAGTTATTAAGGAGACC -> CGAGTTATTAAGGAGACCC
GTCATCCAGGGAGGACCTA -> TCATCCAGGGAGGACCTAC
AGGAGACTTCACCAGCCTG -> GGAGACTTCACCAGCCTGT
ACTGCTCTGTTACTTCAGG -> CTGCTCTGTTACTTCAGGA
CCTTGACGCTGTCCGGGAA -> CTTGACGCTGTCCGGGAAA
GGAGACTTCACCAGCCTGT -> GAGACTTCACCAGCCTGTC
GATTAAAACCGTGCACCAG -> ATTAAAACCGTGCACCAGA
GGAGGAGGGGAGTTCAGGA -> GAGGAGGGGAGTTCAGGAT
AAATATTCAGGAATGAGGC -> AATATTCAGGAATGAGGCA
TGCACTGCAACCGGCGTCA -> GCACTGCAACCGGCGTCAT
CCGAGTAACATGGGGAACA -> CGAGTAACATGGGGAACAT
TAGCAACTGCGGCATTAGA -> AGCAACTGCGGCATTAGAG
GGTCCCGGTGGTGAGAAAT -> GTCCCGGTGGTGAGAAATA
TTGAGTTACAGCCAATTGC -> TGAGTTACAGCCAATTGCT
ACAGTGGCCGAGGACTCCA -> CAGTGGCCGAGGACTCCAC
AACGGACCCCGCGATTTAC -> ACGGACCCCGCGATTTACT
GGAACCCAGATACGGTTCA -> GAACCCAGATACGGTTCAT
CCTTATTTTGGCAGGAACC -> CTTATTTTGGCAGGAACCC
TGATAGAGTAGAGTAAAAG -> GATAGAGTAGAGTAAAAGA
GAGAAATACGTTACGTTAT -> AGAAATACGTTACGTTATA
TGGGGTAGGCGTCTTGACT -> GGGGTAGGCGTCTTGACTC
GAGGCATTCCGCCTCTGCC -> AGGCATTCCGCCTCTGCCA
TCGAGACCAAACTGTGGGA -> CGAGACCAAACTGTGGGAC
ACAGACCAAGATTTTTCCC -> CAGACCAAGATTTTTCCCT
GTTAGGCTATGATTGAGCG -> TTAGGCTATGATTGAGCGT
CGGCGTCATCGTAGTCGCC -> GGCGTCATCGTAGTCGCCA
AGCGCGTCCAACGGACCCC -> GCGCGTCCAACGGACCCCG
ATAGAGGATCACAGTGGCC -> TAGAGGATCACAGTGGCCG
ACTCTGCACTGCCCTAAAC -> CTCTGCACTGCCCTAAACC
CTTACAGCGCAAGCCCGGC -> TTACAGCGCAAGCCCGGCA
GGAAACTGACTGGATAAGA -> GAAACTGACTGGATAAGAT
CCTAAACCTGGTACCTAGT -> CTAAACCTGGTACCTAGTT
TCGCTCACCGTGCCGTATC -> CGCTCACCGTGCCGTATCA
GGGGTCCCGGTGGTGAGAA -> GGGTCCCGGTGGTGAGAAA
ATATTCAGGAATGAGGCAT -> TATTCAGGAATGAGGCATT
CAGGATTTAGAGCGGTTCA -> AGGATTTAGAGCGGTTCAC
TGAGGCATTCGTACGGCAC -> GAGGCATTCGTACGGCACT
TATGGATCTCAAGACTTGC -> ATGGATCTCAAGACTTGCT
AGCAGTCTTACTTGTTTCG -> GCAGTCTTACTTGTTTCGC
GAGGACTCCACAGGTGCCA -> AGGACTCCACAGGTGCCAG
AAGCGTATTTTTCATTTGT -> AGCGTATTTTTCATTTGTT
AGCAACTGCGGCATTAGAG -> GCAACTGCGGCATTAGAGA
GGTACAGTTTCTATAATAC -> GTACAGTTTCTATAATACC
TAAGGACGGCGCAACAGAC -> AAGGACGGCGCAACAGACC
GAGGAACCACTACCCCAAA -> AGGAACCACTACCCCAAAT
CCTACGTCGATGATGTAAG -> CTACGTCGATGATGTAAGC
CCATAGCTTCATAAGACGG -> CATAGCTTCATAAGACGGC
ACGGTCGTTTCCGGTCGAG -> CGGTCGTTTCCGGTCGAGA
CTGCCCTAAACCTGGTACC -> TGCCCTAAACCTGGTACCT
GTCCGGCGCGGACTATTAA -> TCCGGCGCGGACTATTAAC
ACGTCTCGGCACGCACATT -> CGTCTCGGCACGCACATTA
AGCGGTTCACCATCGCGGC -> GCGGTTCACCATCGCGGCA
ACGTTGCCTTTCCAAATGA -> CGTTGCCTTTCCAAATGAG
AGTAGGGCTCCACCACATG -> GTAGGGCTCCACCACATGG
CGAGTAACATGGGGAACAT -> GAGTAACATGGGGAACATG
AACTGACTGGATAAGATCA -> ACTGACTGGATAAGATCAC
TTAGAAGACGCTAGCTGCA -> TAGAAGACGCTAGCTGCAA
CGCGTCCAACGGACCCCGC -> GCGTCCAACGGACCCCGCG
TTCAGGAATGAGGCATTCT -> TCAGGAATGAGGCATTCTA
AGCCGTCGTTCTGCCGTGG -> GCCGTCGTTCTGCCGTGGG
AGTTTCTCCTGTTAGCGTT -> GTTTCTCCTGTTAGCGTTA
TCCGCGTAGGTTTATGGAT -> CCGCGTAGGTTTATGGATC
TTCTCCTGTTAGCGTTAGC -> TCTCCTGTTAGCGTTAGCT
CATTTGTTGGATTAAAACC -> ATTTGTTGGATTAAAACCG
GCACGCACATTAAGGACGG -> CACGCACATTAAGGACGGC
TAGTTGCCCACATTGCACG -> AGTTGCCCACATTGCACGT
TACTATGAGAGCAGTCTTA -> ACTATGAGAGCAGTCTTAC
AGTTATTAAGGAGACCCAT -> GTTATTAAGGAGACCCATA
GATCTCCATAAGAAAAGTG -> ATCTCCATAAGAAAAGTGA
CTCTCATCAGGGTACAGTT -> TCTCATCAGGGTACAGTTT
TTTACTTTCGTTACGGTCG -> TTACTTTCGTTACGGTCGT
CGCAACAGACCAAGATTTT -> GCAACAGACCAAGATTTTT
TCATCATCCGAATATTGCT -> CATCATCCGAATATTGCTA
AGGACGGCGCAACAGACCA -> GGACGGCGCAACAGACCAA
AGAACATGAAAAGGGGACT -> GAACATGAAAAGGGGACTT
AGGCATTCGTACGGCACTA -> GGCATTCGTACGGCACTAA
GTATATAGGTTTGACGGTA -> TATATAGGTTTGACGGTAG
GACGCTAATGCTATTTGTA -> ACGCTAATGCTATTTGTAT
AGTAGCTCATTTACTTTCG -> GTAGCTCATTTACTTTCGT
TCATTTGTTGGATTAAAAC -> CATTTGTTGGATTAAAACC
GCCAATAAAATTACTCTGA -> CCAATAAAATTACTCTGAC
ACTCTCATCAGGGTACAGT -> CTCTCATCAGGGTACAGTT
GTTAGCGTTAGCTAGTTGC -> TTAGCGTTAGCTAGTTGCC
GGGACCCCGTCCTTATTTT -> GGACCCCGTCCTTATTTTG
CTTAGTTCCTGGAACAAGG -> TTAGTTCCTGGAACAAGGG
ACTTCATGGATCTCCATAA -> CTTCATGGATCTCCATAAG
GCTATTTGTATATAGGTTT -> CTATTTGTATATAGGTTTG
ACCCAGATACGGTTCATAC -> CCCAGATACGGTTCATACC
GGATCGCGGCGGACAAGTA -> GATCGCGGCGGACAAGTAT
GCGTTGGCTCAGATACGAG -> CGTTGGCTCAGATACGAGC
TCTAAGCTTAGCGTAGCAA -> CTAAGCTTAGCGTAGCAAC
TATCCATCGGCTGCTATTT -> ATCCATCGGCTGCTATTTG
CCCGCAAAGGAGACCCATA -> CCGCAAAGGAGACCCATAG
AGTTGCCCACATTGCACGT -> GTTGCCCACATTGCACGTC
CATTGTGAGTCTTTGAATA -> ATTGTGAGTCTTTGAATAG
AACTGTAAAGACTCGGTCT -> ACTGTAAAGACTCGGTCTG
GAAGGAGACTTCACCAGCC -> AAGGAGACTTCACCAGCCT
TTCATACCTTTACTCGGTT -> TCATACCTTTACTCGGTTC
GGCACTAAGGAGACCCATA -> GCACTAAGGAGACCCATAG
GCGCACAGAACATGAAAAG -> CGCACAGAACATGAAAAGG
TTGCCAATAAAATTACTCT -> TGCCAATAAAATTACTCTG
ACACCCGTAGTCGCGGGAC -> CACCCGTAGTCGCGGGACT
ACCCTTCCGAGAGTTGTCT -> CCCTTCCGAGAGTTGTCTA
GTGGAGGCTGTCGCTCACC -> TGGAGGCTGTCGCTCACCG
TTACGTGGAGGCTGTCGCT -> TACGTGGAGGCTGTCGCTC
TATGCTACATAAGCTTCGC -> ATGCTACATAAGCTTCGCC
AGGAATGAGGCATTCGTAC -> GGAATGAGGCATTCGTACG
CCTAGTTGTCCGCTTTTAG -> CTAGTTGTCCGCTTTTAGC
AGAAGACGCTAGCTGCAAC -> GAAGACGCTAGCTGCAACG
TAAGACGGCGATGCGAAGT -> AAGACGGCGATGCGAAGTT
GGTAGCTCAGGGCTTGTTA -> GTAGCTCAGGGCTTGTTAG
GTAACATGGGGAACATGCT -> TAACATGGGGAACATGCTT
GATGCGAAGTTATCAGATA -> ATGCGAAGTTATCAGATAC
CGACTCAAGCGTATTTTTC -> GACTCAAGCGTATTTTTCA
TTGCTACACTCTCGGGTTC -> TGCTACACTCTCGGGTTCT
CTGGTACCTAGTTGTCCGC -> TGGTACCTAGTTGTCCGCT
CCCATAGCTTCATTTCGAA -> CCATAGCTTCATTTCGAAA
TGGTATAGATGCCGTTAAT -> GGTATAGATGCCGTTAATA
TAGGTATTTCAGGAATGAG -> AGGTATTTCAGGAATGAGG
AAGCCGTCGTTCTGCCGTG -> AGCCGTCGTTCTGCCGTGG
GCTTGCTGTCCGCGCTACT -> CTTGCTGTCCGCGCTACTC
CAGACGACGCTATGTTAGG -> AGACGACGCTATGTTAGGC
AGGGCTCCACCACATGGTC -> GGGCTCCACCACATGGTCA
CTGTCCCTTCACTGCCGGT -> TGTCCCTTCACTGCCGGTG
CATTCCGCCTCTGCCAAGG -> ATTCCGCCTCTGCCAAGGA
TTTTGGCAGGAACCCAGAT -> TTTGGCAGGAACCCAGATA
GAACGCGGTGAGTTCACTA -> AACGCGGTGAGTTCACTAT
TCAGGAATGAGGCATTCTA -> CAGGAATGAGGCATTCTAT
TCCAGACGGGGCTCCGGAA -> CCAGACGGGGCTCCGGAAC
CAGTCTTACTTGTTTCGCC -> AGTCTTACTTGTTTCGCCG
TATTAACAGGACAGCGTTG -> ATTAACAGGACAGCGTTGG
TGCCCTCCCTCATCATCCG -> GCCCTCCCTCATCATCCGA
ATTTACTTTCGTTACGGTC -> TTTACTTTCGTTACGGTCG
TCCACAGGGAGGAGGGGAG -> CCACAGGGAGGAGGGGAGT
ATTCTATGCCCGCAAAGGA -> TTCTATGCCCGCAAAGGAG
TTAGACGACCATTAATCCC -> TAGACGACCATTAATCCCA
GCCTCTGCCAAGGAGACCC -> CCTCTGCCAAGGAGACCCA
CATCGTAGTCGCCAAATAT -> ATCGTAGTCGCCAAATATG
CATCGCGGCAACTCTTGGG -> ATCGCGGCAACTCTTGGGT
CGCTTGCCCTCCCTCATCA -> GCTTGCCCTCCCTCATCAT
AAGAACGACTCAAGCGTAT -> AGAACGACTCAAGCGTATT
GCTACATAAGCTTCGCCGA -> CTACATAAGCTTCGCCGAC
AATAGCGTTGAGTTACAGC -> ATAGCGTTGAGTTACAGCC
CTACCCCAAATATTCAGGA -> TACCCCAAATATTCAGGAA
CACATTGCACGTCTCGGCA -> ACATTGCACGTCTCGGCAC
GTAGCAACTGCGGCATTAG -> TAGCAACTGCGGCATTAGA
ACTTAGTTCCTGGAACAAG -> CTTAGTTCCTGGAACAAGG
CGGCGGACAAGTATCCATC -> GGCGGACAAGTATCCATCG
GACCTCCGTTCAGACCGAG -> ACCTCCGTTCAGACCGAGT
ATCAGGGTACAGTTTCTAT -> TCAGGGTACAGTTTCTATA
CGACCATTAATCCCACGAG -> GACCATTAATCCCACGAGA
AAGATCACGCACCTGCACT -> AGATCACGCACCTGCACTG
ATTTGTATATAGGTTTGAC -> TTTGTATATAGGTTTGACG
ATATAGGTTTGACGGTAGC -> TATAGGTTTGACGGTAGCT
TCAGGATTTAGAGCGGTTC -> CAGGATTTAGAGCGGTTCA
CTACGTCGATGATGTAAGC -> TACGTCGATGATGTAAGCC
GAGTTCACTATGCTACATA -> AGTTCACTATGCTACATAA
TGCCGGTGCTCCTTTTAGC -> GCCGGTGCTCCTTTTAGCT
GCTGTCGCTCACCGTGCCG -> CTGTCGCTCACCGTGCCGT
TTGCCTTTCCAAATGAGGT -> TGCCTTTCCAAATGAGGTC
AGGAATGAGGCATTCTATG -> GGAATGAGGCATTCTATGC
TCCGCCTCTGCCAAGGAGA -> CCGCCTCTGCCAAGGAGAC
TACGTTATACGGTGGTGTC -> ACGTTATACGGTGGTGTCC
GGCGGACAAGTATCCATCG -> GCGGACAAGTATCCATCGG
CAGCCAATTGCTAACGGGA -> AGCCAATTGCTAACGGGAC
GCACCAACCATAGGAAGGA -> CACCAACCATAGGAAGGAC
TTGTTTCGCCGATCGATGG -> TGTTTCGCCGATCGATGGC
CGCACCAACCATAGGAAGG -> GCACCAACCATAGGAAGGA
GCGGACAAGTATCCATCGG -> CGGACAAGTATCCATCGGC
CCTGGTACCTAGTTGTCCG -> CTGGTACCTAGTTGTCCGC
GAGGGGAGTTCAGGATTTA -> AGGGGAGTTCAGGATTTAG
GCAGTCCACAGGGAGGAGG -> CAGTCCACAGGGAGGAGGG
TACGATAGAGGATCACAGT -> ACGATAGAGGATCACAGTG
TTAGCGTAGCAACTGCGGC -> TAGCGTAGCAACTGCGGCA
AGTGAAGGCGAAGAAGGAG -> GTGAAGGCGAAGAAGGAGA
TTACGTTATACGGTGGTGT -> TACGTTATACGGTGGTGTC
CCTCATCATCCGAATATTG -> CTCATCATCCGAATATTGC
AATTGCTAACGGGACCCCG -> ATTGCTAACGGGACCCCGT
CTTTTAGCCACTAGGCCTC -> TTTTAGCCACTAGGCCTCT
GTGGTACTCCTTACAGCGC -> TGGTACTCCTTACAGCGCA
TGAAAAGGGGACTTGACCG -> GAAAAGGGGACTTGACCGA
ATAAGAAAAGTGATAGAGT -> TAAGAAAAGTGATAGAGTA
CCTCGCGGAGCCCCGACGA -> CTCGCGGAGCCCCGACGAG
TGAAGTAGGGCTCCACCAC -> GAAGTAGGGCTCCACCACA
CTGACTGGATAAGATCACG -> TGACTGGATAAGATCACGC
TAGGCTATGATTGAGCGTT -> AGGCTATGATTGAGCGTTT
GTAAAAGAGTAGCTCATTT -> TAAAAGAGTAGCTCATTTA
TTTAGCCACTAGGCCTCTT -> TTAGCCACTAGGCCTCTTG
GCCTGTCTCTGTCCCTTCA -> CCTGTCTCTGTCCCTTCAC
ATCCAGGGAGGACCTACTC -> TCCAGGGAGGACCTACTCA
TGTTAGACGACCATTAATC -> GTTAGACGACCATTAATCC
GATTTAGATGACGGTGCCC -> ATTTAGATGACGGTGCCCT
TATTGAAGTAGGGCTCCAC -> ATTGAAGTAGGGCTCCACC
CAGTTTCTATAATACCATT -> AGTTTCTATAATACCATTG
GGATCTCAAGACTTGCTAC -> GATCTCAAGACTTGCTACT
ATCTCCATAAGAAAAGTGA -> TCTCCATAAGAAAAGTGAT
CTGCCGGTGCTCCTTTTAG -> TGCCGGTGCTCCTTTTAGC
TGCTACACTCTCGGGTTCT -> GCTACACTCTCGGGTTCTA
TTTCCGGTCGAGACCAAAC -> TTCCGGTCGAGACCAAACT
CTCAGGGCTTGTTAGTTGC -> TCAGGGCTTGTTAGTTGCT
ACTGCAACCGGCGTCATCG -> CTGCAACCGGCGTCATCGT
GTAAGCCGTCGTTCTGCCG -> TAAGCCGTCGTTCTGCCGT
CATTGCACGTCTCGGCACG -> ATTGCACGTCTCGGCACGC
ATCGGCTGCTATTTGTGCC -> TCGGCTGCTATTTGTGCCC
GTCCCGGTGGTGAGAAATA -> TCCCGGTGGTGAGAAATAC
AAAGACTCGGTCTGGACGT -> AAGACTCGGTCTGGACGTT
ATGGTATAGATGCCGTTAA -> TGGTATAGATGCCGTTAAT
GAGCGTTTGCCAATAAAAT -> AGCGTTTGCCAATAAAATT
GGTCTGGACGTTGCCTTTC -> GTCTGGACGTTGCCTTTCC
CGTTGTATGTCATTGACCT -> GTTGTATGTCATTGACCTC
TTCAGACCGAGTAACATGG -> TCAGACCGAGTAACATGGG
CCATAAGAAAAGTGATAGA -> CATAAGAAAAGTGATAGAG
ATGGTCATCCAGGGAGGAC -> TGGTCATCCAGGGAGGACC
CCGTGCCGTATCATGGGAC -> CGTGCCGTATCATGGGACC
TACGTTACGTTATACGGTG -> ACGTTACGTTATACGGTGG
TAAAGACTCGGTCTGGACG -> AAAGACTCGGTCTGGACGT
GCGCTACTCGACAACCGAC -> CGCTACTCGACAACCGACG
TAGAGACTTAGAAGACGCT -> AGAGACTTAGAAGACGCTA
TGGGCGAGAGTTTCTCCTG -> GGGCGAGAGTTTCTCCTGT
AATGAGGCATTCTATGCCC -> ATGAGGCATTCTATGCCCG
AATATTGCTATGACGCCCT -> ATATTGCTATGACGCCCTC
CGGCGCGGACTATTAACAG -> GGCGCGGACTATTAACAGG
ACCGCGCACAGAACATGAA -> CCGCGCACAGAACATGAAA
CTACTATGAGAGCAGTCTT -> TACTATGAGAGCAGTCTTA
CTTGGGCCTTGACGCTGTC -> TTGGGCCTTGACGCTGTCC
AACTGACGAGTTACGCTAG -> ACTGACGAGTTACGCTAGT
ATCATCCGAATATTGCTAT -> TCATCCGAATATTGCTATG
AATGAGGCATTCCGCCTCT -> ATGAGGCATTCCGCCTCTG
ACTGTAAAGACTCGGTCTG -> CTGTAAAGACTCGGTCTGG
TCATAAAACCTCCAGACGG -> CATAAAACCTCCAGACGGG
CCTACGATAGAGGATCACA -> CTACGATAGAGGATCACAG
CATAAGAAAAGTGATAGAG -> ATAAGAAAAGTGATAGAGT
GTCATTGACCTCCGTTCAG -> TCATTGACCTCCGTTCAGA
TAGCGTAGCAACTGCGGCA -> AGCGTAGCAACTGCGGCAT
ATGACGGTGCCCTACGTCG -> TGACGGTGCCCTACGTCGA
TGAGAGCAGTCTTACTTGT -> GAGAGCAGTCTTACTTGTT
ACGGTGGTGTCCTGGGGTA -> CGGTGGTGTCCTGGGGTAG
ATAGCTTCATAAAACCTCC -> TAGCTTCATAAAACCTCCA
GACCGGTATCCCTACGATA -> ACCGGTATCCCTACGATAG
CCAAACTGTGGGACTTGGG -> CAAACTGTGGGACTTGGGC
CATTCTATGCCCGCAAAGG -> ATTCTATGCCCGCAAAGGA
CGATAGAGGATCACAGTGG -> GATAGAGGATCACAGTGGC
ACCTAGTTGTCCGCTTTTA -> CCTAGTTGTCCGCTTTTAG
TCTGTTACTTCAGGAATGA -> CTGTTACTTCAGGAATGAG
TTATCAGATACTCCTTCCC -> TATCAGATACTCCTTCCCG
CACATTAAGGACGGCGCAA -> ACATTAAGGACGGCGCAAC
ACTTTTCCCCGTGTGTTGT -> CTTTTCCCCGTGTGTTGTC
CGGTTCACCATCGCGGCAA -> GGTTCACCATCGCGGCAAC
GTTACAGCCCTCCCCCGTC -> TTACAGCCCTCCCCCGTCT
CGACACCCGTAGTCGCGGG -> GACACCCGTAGTCGCGGGA
TTCACCAGCCTGTCTCTGT -> TCACCAGCCTGTCTCTGTC
CTGCCAAGGAGACCCATAG -> TGCCAAGGAGACCCATAGC
GTTGAGTTACAGCCAATTG -> TTGAGTTACAGCCAATTGC
AGTGTTAGACGACCATTAA -> GTGTTAGACGACCATTAAT
CTTGCTACTATGAGAGCAG -> TTGCTACTATGAGAGCAGT
ATGTCATTGACCTCCGTTC -> TGTCATTGACCTCCGTTCA
GCTAGTTGCCCACATTGCA -> CTAGTTGCCCACATTGCAC
TGATTGAGCGTTTGCCAAT -> GATTGAGCGTTTGCCAATA
GTTATTAAGGAGACCCATA -> TTATTAAGGAGACCCATAG
ATACTTAGTTCCTGGAACA -> TACTTAGTTCCTGGAACAA
CGGGGCTCCGGAACGCGGT -> GGGGCTCCGGAACGCGGTG
CACTAAGGAGACCCATAGC -> ACTAAGGAGACCCATAGCT
TCAGGAATGAGGCATTCAC -> CAGGAATGAGGCATTCACG
AGCTAACTGACGAGTTACG -> GCTAACTGACGAGTTACGC
GAACATGAAAAGGGGACTT -> AACATGAAAAGGGGACTTG
GCACTAACTGTAAAGACTC -> CACTAACTGTAAAGACTCG
CTCATTTACTTTCGTTACG -> TCATTTACTTTCGTTACGG
ACCAAACTGTGGGACTTGG -> CCAAACTGTGGGACTTGGG
GCCAAGGAGACCCATAGCT -> CCAAGGAGACCCATAGCTT
GTATGTGGTACTCCTTACA -> TATGTGGTACTCCTTACAG
CAAATATTCAGGAATGAGG -> AAATATTCAGGAATGAGGC
TCCAAATGAGGTCCGCGTA -> CCAAATGAGGTCCGCGTAG
CGTAGTCGCCAAATATGGT -> GTAGTCGCCAAATATGGTA
TACTCCTTACAGCGCAAGC -> ACTCCTTACAGCGCAAGCC
GCTACTCGACAACCGACGC -> CTACTCGACAACCGACGCT
GATCCTGAGCCCACTCCGC -> ATCCTGAGCCCACTCCGCT
ATTGCTATGACGCCCTCAA -> TTGCTATGACGCCCTCAAT
CGTCTTTAGGACACCCGCA -> GTCTTTAGGACACCCGCAC
AGACTTCACCAGCCTGTCT -> GACTTCACCAGCCTGTCTC
GCACTGCAACCGGCGTCAT -> CACTGCAACCGGCGTCATC
GAAGGACCGCGCACAGAAC -> AAGGACCGCGCACAGAACA
TTGTTAGTTGCTACACTCT -> TGTTAGTTGCTACACTCTC
ATTAGGTATTTCAGGAATG -> TTAGGTATTTCAGGAATGA
CGCTGAGGAACCACTACCC -> GCTGAGGAACCACTACCCC
CAAGCGTATTTTTCATTTG -> AAGCGTATTTTTCATTTGT
GCGCAGTCCACAGGGAGGA -> CGCAGTCCACAGGGAGGAG
TAAGAGTCTGATTTAGATG -> AAGAGTCTGATTTAGATGA
ATAAGCTTCGCCGACGAGG -> TAAGCTTCGCCGACGAGGC
CGCGCTACTCGACAACCGA -> GCGCTACTCGACAACCGAC
CCCATAGCTTCATTGTGCG -> CCATAGCTTCATTGTGCGG
GCTAACGGGACCCCGTCCT -> CTAACGGGACCCCGTCCTT
ATTTCAGGAATGAGGCATT -> TTTCAGGAATGAGGCATTC
GCAACCGGCGTCATCGTAG -> CAACCGGCGTCATCGTAGT
TAGAGGATCACAGTGGCCG -> AGAGGATCACAGTGGCCGA
CTGGACGTTGCCTTTCCAA -> TGGACGTTGCCTTTCCAAA
TGGATACTTAGTTCCTGGA -> GGATACTTAGTTCCTGGAA
TGTGTTGTCCGGCGCGGAC -> GTGTTGTCCGGCGCGGACT
ATCATGGGACCGGTATCCC -> TCATGGGACCGGTATCCCT
TCGACAACCGACGCTAATG -> CGACAACCGACGCTAATGC
AGACCAAGATTTTTCCCTC -> GACCAAGATTTTTCCCTCA
CAGGAATGAGGCATTCGTA -> AGGAATGAGGCATTCGTAC
TTGAATAGCGTTGAGTTAC -> TGAATAGCGTTGAGTTACA
GGTCGTTTCCGGTCGAGAC -> GTCGTTTCCGGTCGAGACC
GCGTTGTATGTCATTGACC -> CGTTGTATGTCATTGACCT
GGTGCCAGCTAACTGACGA -> GTGCCAGCTAACTGACGAG
GTTCACCCTTCCGAGAGTT -> TTCACCCTTCCGAGAGTTG
TATTCAGGAATGAGGCATT -> ATTCAGGAATGAGGCATTC
ACTTCACCAGCCTGTCTCT -> CTTCACCAGCCTGTCTCTG
AGCGTTTGCCAATAAAATT -> GCGTTTGCCAATAAAATTA
GCGTAGCAACTGCGGCATT -> CGTAGCAACTGCGGCATTA
CCCGTCTTTAGGACACCCG -> CCGTCTTTAGGACACCCGC
CGCGGGACTGGATTAAGAG -> GCGGGACTGGATTAAGAGT
TCCCGGTGGTGAGAAATAC -> CCCGGTGGTGAGAAATACG
CTTGTTTCGCCGATCGATG -> TTGTTTCGCCGATCGATGG
AGGAACCCAGATACGGTTC -> GGAACCCAGATACGGTTCA
TGTGCCCGCTTGCCCTCCC -> GTGCCCGCTTGCCCTCCCT
TATTTGTATATAGGTTTGA -> ATTTGTATATAGGTTTGAC
GTCTGCTGATGTATTATTA -> TCTGCTGATGTATTATTAG
TTAGGACACCCGCACCAAC -> TAGGACACCCGCACCAACC
AACATGCTTGCTGTCCGCG -> ACATGCTTGCTGTCCGCGC
CCAAATATGGTATAGATGC -> CAAATATGGTATAGATGCC
CATAAGCTTCGCCGACGAG -> ATAAGCTTCGCCGACGAGG
TGTCCTGGGGTAGGCGTCT -> GTCCTGGGGTAGGCGTCTT
TGCCCACATTGCACGTCTC -> GCCCACATTGCACGTCTCG
TTGCCCTCCCTCATCATCC -> TGCCCTCCCTCATCATCCG
TACCCCAAATATTCAGGAA -> ACCCCAAATATTCAGGAAT
GCCTCTTGCTCGTACTTGA -> CCTCTTGCTCGTACTTGAG
TCACCAGCCTGTCTCTGTC -> CACCAGCCTGTCTCTGTCC
TTGGCTCAGATACGAGCGC -> TGGCTCAGATACGAGCGCC
GCACTGCCCTAAACCTGGT -> CACTGCCCTAAACCTGGTA
ACGGCGATGCGAAGTTATC -> CGGCGATGCGAAGTTATCA
GAATGAGGCATTCACGAGT -> AATGAGGCATTCACGAGTT
TGAGCCCACTCCGCTGAGG -> GAGCCCACTCCGCTGAGGA
GTCTTGACTCTCATCAGGG -> TCTTGACTCTCATCAGGGT
GAGGATCACAGTGGCCGAG -> AGGATCACAGTGGCCGAGG
CGCCTCGCGGAGCCCCGAC -> GCCTCGCGGAGCCCCGACG
GGGCTTGTTAGTTGCTACA -> GGCTTGTTAGTTGCTACAC
TTACGCTAGTAAGGAGCTT -> TACGCTAGTAAGGAGCTTC
TTACTTCATGGATCTCCAT -> TACTTCATGGATCTCCATA
GCGAAGAAGGAGACTTCAC -> CGAAGAAGGAGACTTCACC
CCGAGGACTCCACAGGTGC -> CGAGGACTCCACAGGTGCC
TACGGTTCATACCTTTACT -> ACGGTTCATACCTTTACTC
GGCTCCGGAACGCGGTGAG -> GCTCCGGAACGCGGTGAGT
CATACCTTTACTCGGTTCA -> ATACCTTTACTCGGTTCAC
CCGACGAGGCTGCGTTGTA -> CGACGAGGCTGCGTTGTAT
CTTGCTCGTACTTGAGCGC -> TTGCTCGTACTTGAGCGCG
TCATCCGAATATTGCTATG -> CATCCGAATATTGCTATGA
ATAAGATCACGCACCTGCA -> TAAGATCACGCACCTGCAC
CGCACCTGCACTGCAACCG -> GCACCTGCACTGCAACCGG
GACCGAGTAACATGGGGAA -> ACCGAGTAACATGGGGAAC
TCACTGCCGGTGCTCCTTT -> CACTGCCGGTGCTCCTTTT
GTGCCCTACGTCGATGATG -> TGCCCTACGTCGATGATGT
TCGGTCTGGACGTTGCCTT -> CGGTCTGGACGTTGCCTTT
CGACTGGTGCACTAACTGT -> GACTGGTGCACTAACTGTA
GAGTCTTTGAATAGCGTTG -> AGTCTTTGAATAGCGTTGA
TGACGCCTCGCGGAGCCCC -> GACGCCTCGCGGAGCCCCG
CCCCGTGTGTTGTCCGGCG -> CCCGTGTGTTGTCCGGCGC
TATGTGGTACTCCTTACAG -> ATGTGGTACTCCTTACAGC
CGGACCCCGCGATTTACTT -> GGACCCCGCGATTTACTTC
CTTAGAAGACGCTAGCTGC -> TTAGAAGACGCTAGCTGCA
GTGTTAGACGACCATTAAT -> TGTTAGACGACCATTAATC
TGGTGAGAAATACGTTACG -> GGTGAGAAATACGTTACGT
TTAGTTCCTGGAACAAGGG -> TAGTTCCTGGAACAAGGGG
AGCTGCAACGACACCCGTA -> GCTGCAACGACACCCGTAG
CTGCGTTGTATGTCATTGA -> TGCGTTGTATGTCATTGAC
TTATTTTGGCAGGAACCCA -> TATTTTGGCAGGAACCCAG
CCCCGTCCTTATTTTGGCA -> CCCGTCCTTATTTTGGCAG
ACCATTAATCCCACGAGAT -> CCATTAATCCCACGAGATC
CAGGGCTTGTTAGTTGCTA -> AGGGCTTGTTAGTTGCTAC
GCCCTCCCCCGTCTTTAGG -> CCCTCCCCCGTCTTTAGGA
GGCATTCACGAGTTATTAA -> GCATTCACGAGTTATTAAG
CCTCCAGACGGGGCTCCGG -> CTCCAGACGGGGCTCCGGA
ACGACCATTAATCCCACGA -> CGACCATTAATCCCACGAG
TGACTCTGCACTGCCCTAA -> GACTCTGCACTGCCCTAAA
CTACACTCTCGGGTTCTAA -> TACACTCTCGGGTTCTAAG
AATTACTCTGACTTAGTAT -> ATTACTCTGACTTAGTATG
CCGCCTCTGCCAAGGAGAC -> CGCCTCTGCCAAGGAGACC
CTGCAACCGGCGTCATCGT -> TGCAACCGGCGTCATCGTA
TTCCAAATGAGGTCCGCGT -> TCCAAATGAGGTCCGCGTA
ATCCATCGGCTGCTATTTG -> TCCATCGGCTGCTATTTGT
ACGAGATCCTGAGCCCACT -> CGAGATCCTGAGCCCACTC
TGCAACCGGCGTCATCGTA -> GCAACCGGCGTCATCGTAG
GTCCCTTCACTGCCGGTGC -> TCCCTTCACTGCCGGTGCT
GAGACTTCACCAGCCTGTC -> AGACTTCACCAGCCTGTCT
TTGCACGTCTCGGCACGCA -> TGCACGTCTCGGCACGCAC
TCCAACGGACCCCGCGATT -> CCAACGGACCCCGCGATTT
TATATTGAAGTAGGGCTCC -> ATATTGAAGTAGGGCTCCA
AGGACAGCGTTGGCTCAGA -> GGACAGCGTTGGCTCAGAT
TTGAGCGCGTCCAACGGAC -> TGAGCGCGTCCAACGGACC
TTGTCCGCTTTTAGCCACT -> TGTCCGCTTTTAGCCACTA
TTCGTACGGCACTAAGGAG -> TCGTACGGCACTAAGGAGA
GGCTCAGATACGAGCGCCT -> GCTCAGATACGAGCGCCTG
TTGTATATAGGTTTGACGG -> TGTATATAGGTTTGACGGT
ATCGATGGCCAATTACGTG -> TCGATGGCCAATTACGTGG
TTTATGGATCTCAAGACTT -> TTATGGATCTCAAGACTTG
GTCCGGGAAACTGACTGGA -> TCCGGGAAACTGACTGGAT
GAGGACCTACTCACTTTTC -> AGGACCTACTCACTTTTCC
TAGCGTTAGCTAGTTGCCC -> AGCGTTAGCTAGTTGCCCA
CGTACTTGAGCGCGTCCAA -> GTACTTGAGCGCGTCCAAC
CGATGCGAAGTTATCAGAT -> GATGCGAAGTTATCAGATA
TTGGCAGGAACCCAGATAC -> TGGCAGGAACCCAGATACG
ATAGCTTCATTTCGAAAAG -> TAGCTTCATTTCGAAAAGA
CAACCATAGGAAGGACCGC -> AACCATAGGAAGGACCGCG
AGGGTACAGTTTCTATAAT -> GGGTACAGTTTCTATAATA
AATCCCACGAGATCCTGAG -> ATCCCACGAGATCCTGAGC
GATAGAGGATCACAGTGGC -> ATAGAGGATCACAGTGGCC
CCGGTGGTGAGAAATACGT -> CGGTGGTGAGAAATACGTT
TTGACGGTAGCTCAGGGCT -> TGACGGTAGCTCAGGGCTT
GTCCGCGTAGGTTTATGGA -> TCCGCGTAGGTTTATGGAT
GGGAGGAGGGGAGTTCAGG -> GGAGGAGGGGAGTTCAGGA
ACCCCGTCCTTATTTTGGC -> CCCCGTCCTTATTTTGGCA
TAAGGAGCTTCGAACTGCT -> AAGGAGCTTCGAACTGCTC
TGTCTATATTGAAGTAGGG -> GTCTATATTGAAGTAGGGC
ATCTCAAGACTTGCTACTA -> TCTCAAGACTTGCTACTAT
AGACTTGCTACTATGAGAG -> GACTTGCTACTATGAGAGC
TTCCCGGGGTCCCGGTGGT -> TCCCGGGGTCCCGGTGGTG
ATTTGTTGGATTAAAACCG -> TTTGTTGGATTAAAACCGT
CGTATTTTTCATTTGTTGG -> GTATTTTTCATTTGTTGGA
AGGATCACAGTGGCCGAGG -> GGATCACAGTGGCCGAGGA
CGTTCTGCCGTGGGCGAGA -> GTTCTGCCGTGGGCGAGAG
GTTGTCCGGCGCGGACTAT -> TTGTCCGGCGCGGACTATT
GTTCAGGATTTAGAGCGGT -> TTCAGGATTTAGAGCGGTT
CCACTAGGCCTCTTGCTCG -> CACTAGGCCTCTTGCTCGT
CTTGACGCTGTCCGGGAAA -> TTGACGCTGTCCGGGAAAC
TGGATTAAGAGTCTGATTT -> GGATTAAGAGTCTGATTTA
TGTCATTGACCTCCGTTCA -> GTCATTGACCTCCGTTCAG
GGACGGCGCAACAGACCAA -> GACGGCGCAACAGACCAAG
AGTGGCCGAGGACTCCACA -> GTGGCCGAGGACTCCACAG
TCGGCACGCACATTAAGGA -> CGGCACGCACATTAAGGAC
CAACGACACCCGTAGTCGC -> AACGACACCCGTAGTCGCG
CTCTGTCCCTTCACTGCCG -> TCTGTCCCTTCACTGCCGG
CCAATTACGTGGAGGCTGT -> CAATTACGTGGAGGCTGTC
AATGAGGTCCGCGTAGGTT -> ATGAGGTCCGCGTAGGTTT
CCATCGCGGCAACTCTTGG -> CATCGCGGCAACTCTTGGG
TTTGAATAGCGTTGAGTTA -> TTGAATAGCGTTGAGTTAC
TCGCCGACGAGGCTGCGTT -> CGCCGACGAGGCTGCGTTG
ACGACGCTATGTTAGGCTA -> CGACGCTATGTTAGGCTAT
AGTTACGCTAGTAAGGAGC -> GTTACGCTAGTAAGGAGCT
CCATAGCTTCATAAAACCT -> CATAGCTTCATAAAACCTC
GGGACTGGATTAAGAGTCT -> GGACTGGATTAAGAGTCTG
GACGCCTCGCGGAGCCCCG -> ACGCCTCGCGGAGCCCCGA
CGCGGAGCCCCGACGAGTG -> GCGGAGCCCCGACGAGTGT
AAAAGGGGACTTGACCGAC -> AAAGGGGACTTGACCGACT
TCGCGGCAACTCTTGGGTT -> CGCGGCAACTCTTGGGTTC
TTTCATTTGTTGGATTAAA -> TTCATTTGTTGGATTAAAA
ATACTCCTTCCCGGGGTCC -> TACTCCTTCCCGGGGTCCC
GCGGGACTGGATTAAGAGT -> CGGGACTGGATTAAGAGTC
TCCGAATATTGCTATGACG -> CCGAATATTGCTATGACGC
GGCAGGAACCCAGATACGG -> GCAGGAACCCAGATACGGT
CCTGAGCCCACTCCGCTGA -> CTGAGCCCACTCCGCTGAG
AAGGACGGCGCAACAGACC -> AGGACGGCGCAACAGACCA
TAACGGGACCCCGTCCTTA -> AACGGGACCCCGTCCTTAT
GTAGTCGCGGGACTGGATT -> TAGTCGCGGGACTGGATTA
GTTCCTGGAACAAGGGGAT -> TTCCTGGAACAAGGGGATC
TAGGAAGGACCGCGCACAG -> AGGAAGGACCGCGCACAGA
CCTGACGCCTCGCGGAGCC -> CTGACGCCTCGCGGAGCCC
TAAGAAAAGTGATAGAGTA -> AAGAAAAGTGATAGAGTAG
ACGTGGAGGCTGTCGCTCA -> CGTGGAGGCTGTCGCTCAC
CACAGGGAGGAGGGGAGTT -> ACAGGGAGGAGGGGAGTTC
TAATACCATTGGATACTTA -> AATACCATTGGATACTTAG
GGGGTAGGCGTCTTGACTC -> GGGTAGGCGTCTTGACTCT
AAGGCGAAGAAGGAGACTT -> AGGCGAAGAAGGAGACTTC
GGATCACAGTGGCCGAGGA -> GATCACAGTGGCCGAGGAC
GACTCTGCACTGCCCTAAA -> ACTCTGCACTGCCCTAAAC
TACTCGACAACCGACGCTA -> ACTCGACAACCGACGCTAA
AAGAAGGAGACTTCACCAG -> AGAAGGAGACTTCACCAGC
CTTTCGTTACGGTCGTTTC -> TTTCGTTACGGTCGTTTCC
GTTACGCTAGTAAGGAGCT -> TTACGCTAGTAAGGAGCTT
GGTGCACTAACTGTAAAGA -> GTGCACTAACTGTAAAGAC
TCTCCATAAGAAAAGTGAT -> CTCCATAAGAAAAGTGATA
GGTGGTGAGAAATACGTTA -> GTGGTGAGAAATACGTTAC
GTATTTTTCATTTGTTGGA -> TATTTTTCATTTGTTGGAT
GGAGCCCCGACGAGTGTTA -> GAGCCCCGACGAGTGTTAG
CGGTTCATACCTTTACTCG -> GGTTCATACCTTTACTCGG
TTGAGCGTTTGCCAATAAA -> TGAGCGTTTGCCAATAAAA
CGGTATCCCTACGATAGAG -> GGTATCCCTACGATAGAGG
GTTCACCATCGCGGCAACT -> TTCACCATCGCGGCAACTC
GTGGCCGAGGACTCCACAG -> TGGCCGAGGACTCCACAGG
CAATTCAAGTGAAGGCGAA -> AATTCAAGTGAAGGCGAAG
TACTCACTTTTCCCCGTGT -> ACTCACTTTTCCCCGTGTG
ACTCCTTACAGCGCAAGCC -> CTCCTTACAGCGCAAGCCC
GCATTCTATGCCCGCAAAG -> CATTCTATGCCCGCAAAGG
CACTCCGCTGAGGAACCAC -> ACTCCGCTGAGGAACCACT
TCAAGCGTATTTTTCATTT -> CAAGCGTATTTTTCATTTG
GCACCTGCACTGCAACCGG -> CACCTGCACTGCAACCGGC
ACGGTGCCCTACGTCGATG -> CGGTGCCCTACGTCGATGA
AGGCCTCTTGCTCGTACTT -> GGCCTCTTGCTCGTACTTG
CGGTTCACCCTTCCGAGAG -> GGTTCACCCTTCCGAGAGT
GGCATTCCGCCTCTGCCAA -> GCATTCCGCCTCTGCCAAG
TCCCTCATCATCCGAATAT -> CCCTCATCATCCGAATATT
TCATAAGACGGCGATGCGA -> CATAAGACGGCGATGCGAA
TATTGCTATGACGCCCTCA -> ATTGCTATGACGCCCTCAA
CTGCTATTTGTGCCCGCTT -> TGCTATTTGTGCCCGCTTG
GTCATCGTAGTCGCCAAAT -> TCATCGTAGTCGCCAAATA
ATAAAATTACTCTGACTTA -> TAAAATTACTCTGACTTAG
GGCATTCTATGCCCGCAAA -> GCATTCTATGCCCGCAAAG
AGACCCATAGCTTCATAAA -> GACCCATAGCTTCATAAAA
ACATGGTCATCCAGGGAGG -> CATGGTCATCCAGGGAGGA
GGCGATGCGAAGTTATCAG -> GCGATGCGAAGTTATCAGA
GTACTTGAGCGCGTCCAAC -> TACTTGAGCGCGTCCAACG
GGGTTCTAAGCTTAGCGTA -> GGTTCTAAGCTTAGCGTAG
ACCTACTCACTTTTCCCCG -> CCTACTCACTTTTCCCCGT
TAGACGACCATTAATCCCA -> AGACGACCATTAATCCCAC
AGAGTTTCTCCTGTTAGCG -> GAGTTTCTCCTGTTAGCGT
GCCGGTTACAGCCCTCCCC -> CCGGTTACAGCCCTCCCCC
AGAGTCTGATTTAGATGAC -> GAGTCTGATTTAGATGACG
CATGGGGAACATGCTTGCT -> ATGGGGAACATGCTTGCTG
TTACTCGGTTCACCCTTCC -> TACTCGGTTCACCCTTCCG
GCACTAAGGAGACCCATAG -> CACTAAGGAGACCCATAGC
GCCCTAAACCTGGTACCTA -> CCCTAAACCTGGTACCTAG
ACTAGGCCTCTTGCTCGTA -> CTAGGCCTCTTGCTCGTAC
TGCACTGCCCTAAACCTGG -> GCACTGCCCTAAACCTGGT
TTTGCCAATAAAATTACTC -> TTGCCAATAAAATTACTCT
TAGGTTTATGGATCTCAAG -> AGGTTTATGGATCTCAAGA
CGATTTACTTCATGGATCT -> GATTTACTTCATGGATCTC
CGCAAAGGAGACCCATAGC -> GCAAAGGAGACCCATAGCT
GCTATTTGTGCCCGCTTGC -> CTATTTGTGCCCGCTTGCC
TCTCCTGTTAGCGTTAGCT -> CTCCTGTTAGCGTTAGCTA
ATACCTTTACTCGGTTCAC -> TACCTTTACTCGGTTCACC
CGTTGCCTTTCCAAATGAG -> GTTGCCTTTCCAAATGAGG
CCGTGGGCGAGAGTTTCTC -> CGTGGGCGAGAGTTTCTCC
AGCGCAAGCCCGGCAATTC -> GCGCAAGCCCGGCAATTCA
TCCATAAGAAAAGTGATAG -> CCATAAGAAAAGTGATAGA
CTGATGTATTATTAGGTAT -> TGATGTATTATTAGGTATT
TCATGGATCTCCATAAGAA -> CATGGATCTCCATAAGAAA
GGCCTCTTGCTCGTACTTG -> GCCTCTTGCTCGTACTTGA
CAAGATTTTTCCCTCATTG -> AAGATTTTTCCCTCATTGT
GGAACGCGGTGAGTTCACT -> GAACGCGGTGAGTTCACTA
CTAGTTGCCCACATTGCAC -> TAGTTGCCCACATTGCACG
ACCGTGCCGTATCATGGGA -> CCGTGCCGTATCATGGGAC
CACATGGTCATCCAGGGAG -> ACATGGTCATCCAGGGAGG
CATCGGCTGCTATTTGTGC -> ATCGGCTGCTATTTGTGCC
GACGACCATTAATCCCACG -> ACGACCATTAATCCCACGA
GCACAGAACATGAAAAGGG -> CACAGAACATGAAAAGGGG
CCTTCACTGCCGGTGCTCC -> CTTCACTGCCGGTGCTCCT
TGCTGATGTATTATTAGGT -> GCTGATGTATTATTAGGTA
GTTTGACGGTAGCTCAGGG -> TTTGACGGTAGCTCAGGGC
GCTGCAACGACACCCGTAG -> CTGCAACGACACCCGTAGT
ACCCGTAGTCGCGGGACTG -> CCCGTAGTCGCGGGACTGG
TAAAACCGTGCACCAGACG -> AAAACCGTGCACCAGACGA
GTTACAGCCAATTGCTAAC -> TTACAGCCAATTGCTAACG
ACCGAGTAACATGGGGAAC -> CCGAGTAACATGGGGAACA
GGAGGACCTACTCACTTTT -> GAGGACCTACTCACTTTTC
TCATTTCGAAAAGAACGAC -> CATTTCGAAAAGAACGACT
TACATAAGCTTCGCCGACG -> ACATAAGCTTCGCCGACGA
TGCTATTTGTATATAGGTT -> GCTATTTGTATATAGGTTT
GTTGTCCGCTTTTAGCCAC -> TTGTCCGCTTTTAGCCACT
TCCAGGGAGGACCTACTCA -> CCAGGGAGGACCTACTCAC
CCCGACGAGTGTTAGACGA -> CCGACGAGTGTTAGACGAC
GAAGTTATCAGATACTCCT -> AAGTTATCAGATACTCCTT
CCTACTCACTTTTCCCCGT -> CTACTCACTTTTCCCCGTG
GCGGCAACTCTTGGGTTCA -> CGGCAACTCTTGGGTTCAG
AGATACTCCTTCCCGGGGT -> GATACTCCTTCCCGGGGTC
CTTCGCCGACGAGGCTGCG -> TTCGCCGACGAGGCTGCGT
CCGTGCACCAGACGACGCT -> CGTGCACCAGACGACGCTA
TGTAAGCCGTCGTTCTGCC -> GTAAGCCGTCGTTCTGCCG
CCACCACATGGTCATCCAG -> CACCACATGGTCATCCAGG
TGTGCGGTGACTCTGCACT -> GTGCGGTGACTCTGCACTG
GACACCCGCACCAACCATA -> ACACCCGCACCAACCATAG
GAGGCTGTCGCTCACCGTG -> AGGCTGTCGCTCACCGTGC
GATACGAGCGCCTGACGCC -> ATACGAGCGCCTGACGCCT
AGTTGCTACACTCTCGGGT -> GTTGCTACACTCTCGGGTT
AGCGTATTTTTCATTTGTT -> GCGTATTTTTCATTTGTTG
TCCCTACGATAGAGGATCA -> CCCTACGATAGAGGATCAC
TAGTCGCGGGACTGGATTA -> AGTCGCGGGACTGGATTAA
TGGAACAAGGGGATCGCGG -> GGAACAAGGGGATCGCGGC
AAAGGAGACCCATAGCTTC -> AAGGAGACCCATAGCTTCA
ACCGTGCACCAGACGACGC -> CCGTGCACCAGACGACGCT
GAGATCCTGAGCCCACTCC -> AGATCCTGAGCCCACTCCG
GCGAGAGTTTCTCCTGTTA -> CGAGAGTTTCTCCTGTTAG
CCATAGCTTCATTTCGAAA -> CATAGCTTCATTTCGAAAA
GCTTGTTAGTTGCTACACT -> CTTGTTAGTTGCTACACTC
TTGCTACTATGAGAGCAGT -> TGCTACTATGAGAGCAGTC
CTCCTTACAGCGCAAGCCC -> TCCTTACAGCGCAAGCCCG
CTACGATAGAGGATCACAG -> TACGATAGAGGATCACAGT
CGCCTCTGCCAAGGAGACC -> GCCTCTGCCAAGGAGACCC
TACGCTAGTAAGGAGCTTC -> ACGCTAGTAAGGAGCTTCG
GACGCTATGTTAGGCTATG -> ACGCTATGTTAGGCTATGA
TCGCGGGACTGGATTAAGA -> CGCGGGACTGGATTAAGAG
CTAATGCTATTTGTATATA -> TAATGCTATTTGTATATAG
TGGCCAATTACGTGGAGGC -> GGCCAATTACGTGGAGGCT
CGCAGTCCACAGGGAGGAG -> GCAGTCCACAGGGAGGAGG
GCAAAGGAGACCCATAGCT -> CAAAGGAGACCCATAGCTT
CCCCGCGATTTACTTCATG -> CCCGCGATTTACTTCATGG
TGATGTAAGCCGTCGTTCT -> GATGTAAGCCGTCGTTCTG
AAATGAGGTCCGCGTAGGT -> AATGAGGTCCGCGTAGGTT
CTCCTTCCCGGGGTCCCGG -> TCCTTCCCGGGGTCCCGGT
CTTCAGGAATGAGGCATTC -> TTCAGGAATGAGGCATTCC
GCTTTTAGCCACTAGGCCT -> CTTTTAGCCACTAGGCCTC
GTCTCTGTCCCTTCACTGC -> TCTCTGTCCCTTCACTGCC
AGCTTAGCGTAGCAACTGC -> GCTTAGCGTAGCAACTGCG
ACCGACGCTAATGCTATTT -> CCGACGCTAATGCTATTTG
TCAAGGCGGTCTGCTGATG -> CAAGGCGGTCTGCTGATGT
ACCGACTGGTGCACTAACT -> CCGACTGGTGCACTAACTG
ATGCGAAGTTATCAGATAC -> TGCGAAGTTATCAGATACT
CAACAGACCAAGATTTTTC -> AACAGACCAAGATTTTTCC
CGATGATGTAAGCCGTCGT -> GATGATGTAAGCCGTCGTT
GCCAATTGCTAACGGGACC -> CCAATTGCTAACGGGACCC
GATTTAGAGCGGTTCACCA -> ATTTAGAGCGGTTCACCAT
GAACATGCTTGCTGTCCGC -> AACATGCTTGCTGTCCGCG
TGCCCGCTTGCCCTCCCTC -> GCCCGCTTGCCCTCCCTCA
ATTGCTAACGGGACCCCGT -> TTGCTAACGGGACCCCGTC
TTTAGAGCGGTTCACCATC -> TTAGAGCGGTTCACCATCG
CCCTACGATAGAGGATCAC -> CCTACGATAGAGGATCACA
TTATGGATCTCAAGACTTG -> TATGGATCTCAAGACTTGC
CATTGGATACTTAGTTCCT -> ATTGGATACTTAGTTCCTG
TGACGAGTTACGCTAGTAA -> GACGAGTTACGCTAGTAAG
GGGGATCGCGGCGGACAAG -> GGGATCGCGGCGGACAAGT
TTTCAGGAATGAGGCATTC -> TTCAGGAATGAGGCATTCT
CTATGCTACATAAGCTTCG -> TATGCTACATAAGCTTCGC
GATACTTAGTTCCTGGAAC -> ATACTTAGTTCCTGGAACA
ATGAGGCATTCACGAGTTA -> TGAGGCATTCACGAGTTAT
GAGTTCAGGATTTAGAGCG -> AGTTCAGGATTTAGAGCGG
CCTTACAGCGCAAGCCCGG -> CTTACAGCGCAAGCCCGGC
GGAATGAGGCATTCCGCCT -> GAATGAGGCATTCCGCCTC
GCCAAATATGGTATAGATG -> CCAAATATGGTATAGATGC
TGACTCTCATCAGGGTACA -> GACTCTCATCAGGGTACAG
GACGCCCTCAATGTCAAGG -> ACGCCCTCAATGTCAAGGC
TCCTTCCCGGGGTCCCGGT -> CCTTCCCGGGGTCCCGGTG
TGCGTTGTATGTCATTGAC -> GCGTTGTATGTCATTGACC
TCTATAATACCATTGGATA -> CTATAATACCATTGGATAC
GCTCTGTTACTTCAGGAAT -> CTCTGTTACTTCAGGAATG
CCTCATTGTGAGTCTTTGA -> CTCATTGTGAGTCTTTGAA
CTGCAACGACACCCGTAGT -> TGCAACGACACCCGTAGTC
CATTTACTTTCGTTACGGT -> ATTTACTTTCGTTACGGTC
CTTCATAAAACCTCCAGAC -> TTCATAAAACCTCCAGACG
TAGCGCAGTCCACAGGGAG -> AGCGCAGTCCACAGGGAGG
GAGTTGTCTATATTGAAGT -> AGTTGTCTATATTGAAGTA
GCTGTCCGCGCTACTCGAC -> CTGTCCGCGCTACTCGACA
ACAACCGACGCTAATGCTA -> CAACCGACGCTAATGCTAT
TATCCCTACGATAGAGGAT -> ATCCCTACGATAGAGGATC
TCGTTACGGTCGTTTCCGG -> CGTTACGGTCGTTTCCGGT
CGTCCAACGGACCCCGCGA -> GTCCAACGGACCCCGCGAT
ACACCCGCACCAACCATAG -> CACCCGCACCAACCATAGG
CAGACGGGGCTCCGGAACG -> AGACGGGGCTCCGGAACGC
ATACGGTTCATACCTTTAC -> TACGGTTCATACCTTTACT
GACCCATAGCTTCATTTCG -> ACCCATAGCTTCATTTCGA
ATGCTACATAAGCTTCGCC -> TGCTACATAAGCTTCGCCG
TACTTCATGGATCTCCATA -> ACTTCATGGATCTCCATAA
TCTCGGGTTCTAAGCTTAG -> CTCGGGTTCTAAGCTTAGC
GAGTTATTAAGGAGACCCA -> AGTTATTAAGGAGACCCAT
CCTGGGGTAGGCGTCTTGA -> CTGGGGTAGGCGTCTTGAC
AATATTCAGGAATGAGGCA -> ATATTCAGGAATGAGGCAT
GACGTTGCCTTTCCAAATG -> ACGTTGCCTTTCCAAATGA
GCGCAACAGACCAAGATTT -> CGCAACAGACCAAGATTTT
CCTTCCCGGGGTCCCGGTG -> CTTCCCGGGGTCCCGGTGG
AAGAGTCTGATTTAGATGA -> AGAGTCTGATTTAGATGAC
AACCGACGCTAATGCTATT -> ACCGACGCTAATGCTATTT
TGAGCGTTTGCCAATAAAA -> GAGCGTTTGCCAATAAAAT
CATAGCTTCATTTCGAAAA -> ATAGCTTCATTTCGAAAAG
TGTCCGCTTTTAGCCACTA -> GTCCGCTTTTAGCCACTAG
CTGGAACAAGGGGATCGCG -> TGGAACAAGGGGATCGCGG
ATCCTGAGCCCACTCCGCT -> TCCTGAGCCCACTCCGCTG
TACACTCTCGGGTTCTAAG -> ACACTCTCGGGTTCTAAGC
TCACCCTTCCGAGAGTTGT -> CACCCTTCCGAGAGTTGTC
TGCTATTTGTGCCCGCTTG -> GCTATTTGTGCCCGCTTGC
ATTTACTTCATGGATCTCC -> TTTACTTCATGGATCTCCA
GCCTGACGCCTCGCGGAGC -> CCTGACGCCTCGCGGAGCC
TTCACTGCCGGTGCTCCTT -> TCACTGCCGGTGCTCCTTT
ACAGGGAGGAGGGGAGTTC -> CAGGGAGGAGGGGAGTTCA
CCACGAGATCCTGAGCCCA -> CACGAGATCCTGAGCCCAC
CCCGTCCTTATTTTGGCAG -> CCGTCCTTATTTTGGCAGG
CGGAACGCGGTGAGTTCAC -> GGAACGCGGTGAGTTCACT
CTTCCCGGGGTCCCGGTGG -> TTCCCGGGGTCCCGGTGGT
GATCACAGTGGCCGAGGAC -> ATCACAGTGGCCGAGGACT
AGATGACGGTGCCCTACGT -> GATGACGGTGCCCTACGTC
TATAATACCATTGGATACT -> ATAATACCATTGGATACTT
AGACGGGGCTCCGGAACGC -> GACGGGGCTCCGGAACGCG
TACTTGTTTCGCCGATCGA -> ACTTGTTTCGCCGATCGAT
GAGCGCGTCCAACGGACCC -> AGCGCGTCCAACGGACCCC
TTACTTCAGGAATGAGGCA -> TACTTCAGGAATGAGGCAT
CCCTCAATGTCAAGGCGGT -> CCTCAATGTCAAGGCGGTC
GACTTGACCGACTGGTGCA -> ACTTGACCGACTGGTGCAC
GCTTCATTGTGCGGTGACT -> CTTCATTGTGCGGTGACTC
GCCGATCGATGGCCAATTA -> CCGATCGATGGCCAATTAC
ATGTCAAGGCGGTCTGCTG -> TGTCAAGGCGGTCTGCTGA
CATTCACGAGTTATTAAGG -> ATTCACGAGTTATTAAGGA
AAGGAGACTTCACCAGCCT -> AGGAGACTTCACCAGCCTG
ATTCACGAGTTATTAAGGA -> TTCACGAGTTATTAAGGAG
CGCTTTTAGCCACTAGGCC -> GCTTTTAGCCACTAGGCCT
CAATTACGTGGAGGCTGTC -> AATTACGTGGAGGCTGTCG
GCTATGTTAGGCTATGATT -> CTATGTTAGGCTATGATTG
TAGAGTAAAAGAGTAGCTC -> AGAGTAAAAGAGTAGCTCA
GAGACTTAGAAGACGCTAG -> AGACTTAGAAGACGCTAGC
GCTATGATTGAGCGTTTGC -> CTATGATTGAGCGTTTGCC
GCTTCATAAAACCTCCAGA -> CTTCATAAAACCTCCAGAC
TGCTCCTTTTAGCTACAAT -> GCTCCTTTTAGCTACAATT
TGAGGCATTCTATGCCCGC -> GAGGCATTCTATGCCCGCA
CTTTCCAAATGAGGTCCGC -> TTTCCAAATGAGGTCCGCG
TCCTTACAGCGCAAGCCCG -> CCTTACAGCGCAAGCCCGG
GGAGCTTCGAACTGCTCTG -> GAGCTTCGAACTGCTCTGT
GCGGCGGACAAGTATCCAT -> CGGCGGACAAGTATCCATC
ACGCCTCGCGGAGCCCCGA -> CGCCTCGCGGAGCCCCGAC
ATAGCGTTGAGTTACAGCC -> TAGCGTTGAGTTACAGCCA
ACATTGCACGTCTCGGCAC -> CATTGCACGTCTCGGCACG
TTCACGAGTTATTAAGGAG -> TCACGAGTTATTAAGGAGA
TTCGAACTGCTCTGTTACT -> TCGAACTGCTCTGTTACTT
CGCACATTAAGGACGGCGC -> GCACATTAAGGACGGCGCA
TCATTGTGCGGTGACTCTG -> CATTGTGCGGTGACTCTGC
GACTGGTGCACTAACTGTA -> ACTGGTGCACTAACTGTAA
ACAGGTGCCAGCTAACTGA -> CAGGTGCCAGCTAACTGAC
CGCAAGCCCGGCAATTCAA -> GCAAGCCCGGCAATTCAAG
CGGCAATTCAAGTGAAGGC -> GGCAATTCAAGTGAAGGCG
AGACTTAGAAGACGCTAGC -> GACTTAGAAGACGCTAGCT
GAGACCAAACTGTGGGACT -> AGACCAAACTGTGGGACTT
TTCCGCCTCTGCCAAGGAG -> TCCGCCTCTGCCAAGGAGA
TGCCCTAAACCTGGTACCT -> GCCCTAAACCTGGTACCTA
TAAGCTTAGCGTAGCAACT -> AAGCTTAGCGTAGCAACTG
AACCGGCGTCATCGTAGTC -> ACCGGCGTCATCGTAGTCG
AGGTTTATGGATCTCAAGA -> GGTTTATGGATCTCAAGAC
ATTGTGAGTCTTTGAATAG -> TTGTGAGTCTTTGAATAGC
TGCTACTATGAGAGCAGTC -> GCTACTATGAGAGCAGTCT
CAGAACATGAAAAGGGGAC -> AGAACATGAAAAGGGGACT
CTGGATAAGATCACGCACC -> TGGATAAGATCACGCACCT
GATTTACTTCATGGATCTC -> ATTTACTTCATGGATCTCC
CTAAGCTTAGCGTAGCAAC -> TAAGCTTAGCGTAGCAACT
TTTGTTGGATTAAAACCGT -> TTGTTGGATTAAAACCGTG
GCCCTCAATGTCAAGGCGG -> CCCTCAATGTCAAGGCGGT
ATTTAGATGACGGTGCCCT -> TTTAGATGACGGTGCCCTA
AAGGGGATCGCGGCGGACA -> AGGGGATCGCGGCGGACAA
ACTCGACAACCGACGCTAA -> CTCGACAACCGACGCTAAT
TAAACCTGGTACCTAGTTG -> AAACCTGGTACCTAGTTGT
CAAAGGAGACCCATAGCTT -> AAAGGAGACCCATAGCTTC
GACCCATAGCTTCATAAAA -> ACCCATAGCTTCATAAAAC
AGCGTTAGCTAGTTGCCCA -> GCGTTAGCTAGTTGCCCAC
CCATCGGCTGCTATTTGTG -> CATCGGCTGCTATTTGTGC
AGGCGAAGAAGGAGACTTC -> GGCGAAGAAGGAGACTTCA
CAGCGTTGGCTCAGATACG -> AGCGTTGGCTCAGATACGA
ATCAGATACTCCTTCCCGG -> TCAGATACTCCTTCCCGGG
TTAATAGCGCAGTCCACAG -> TAATAGCGCAGTCCACAGG
GAAGTAGGGCTCCACCACA -> AAGTAGGGCTCCACCACAT
CTTTTCCCCGTGTGTTGTC -> TTTTCCCCGTGTGTTGTCC
ATCGCGGCAACTCTTGGGT -> TCGCGGCAACTCTTGGGTT
CACCAGACGACGCTATGTT -> ACCAGACGACGCTATGTTA
GAAATACGTTACGTTATAC -> AAATACGTTACGTTATACG
CAGGAATGAGGCATTCTAT -> AGGAATGAGGCATTCTATG
AACATGGGGAACATGCTTG -> ACATGGGGAACATGCTTGC
GAATGAGGCATTCTATGCC -> AATGAGGCATTCTATGCCC
GCTTGCCCTCCCTCATCAT -> CTTGCCCTCCCTCATCATC
TGTTACTTCAGGAATGAGG -> GTTACTTCAGGAATGAGGC
CGGTCGTTTCCGGTCGAGA -> GGTCGTTTCCGGTCGAGAC
GTACAGTTTCTATAATACC -> TACAGTTTCTATAATACCA
TCAAGTGAAGGCGAAGAAG -> CAAGTGAAGGCGAAGAAGG
AGCTCATTTACTTTCGTTA -> GCTCATTTACTTTCGTTAC
ATAAAACCTCCAGACGGGG -> TAAAACCTCCAGACGGGGC
GTCCTGGGGTAGGCGTCTT -> TCCTGGGGTAGGCGTCTTG
TACAGCCCTCCCCCGTCTT -> ACAGCCCTCCCCCGTCTTT
ACCAGACGACGCTATGTTA -> CCAGACGACGCTATGTTAG
TACGTGGAGGCTGTCGCTC -> ACGTGGAGGCTGTCGCTCA
GCATTAGAGACTTAGAAGA -> CATTAGAGACTTAGAAGAC
AGCTTCATAAAACCTCCAG -> GCTTCATAAAACCTCCAGA
GTTCTGCCGTGGGCGAGAG -> TTCTGCCGTGGGCGAGAGT
CGGTCTGCTGATGTATTAT -> GGTCTGCTGATGTATTATT
AGCGCAGTCCACAGGGAGG -> GCGCAGTCCACAGGGAGGA
ATTAAGGACGGCGCAACAG -> TTAAGGACGGCGCAACAGA
CTCTGTTACTTCAGGAATG -> TCTGTTACTTCAGGAATGA
AGCTTCATTGTGCGGTGAC -> GCTTCATTGTGCGGTGACT
ATTTTTCCCTCATTGTGAG -> TTTTTCCCTCATTGTGAGT
TGCTACATAAGCTTCGCCG -> GCTACATAAGCTTCGCCGA
CTTATTTTGGCAGGAACCC -> TTATTTTGGCAGGAACCCA
CCGAGAGTTGTCTATATTG -> CGAGAGTTGTCTATATTGA
CACTAGGCCTCTTGCTCGT -> ACTAGGCCTCTTGCTCGTA
CTCCATAAGAAAAGTGATA -> TCCATAAGAAAAGTGATAG
AAAACCTCCAGACGGGGCT -> AAACCTCCAGACGGGGCTC
GTTTCTATAATACCATTGG -> TTTCTATAATACCATTGGA
GCCGACGAGGCTGCGTTGT -> CCGACGAGGCTGCGTTGTA
GTTCAGACCGAGTAACATG -> TTCAGACCGAGTAACATGG
CCACTCCGCTGAGGAACCA -> CACTCCGCTGAGGAACCAC
CTTCATTGTGCGGTGACTC -> TTCATTGTGCGGTGACTCT
GATGACGGTGCCCTACGTC -> ATGACGGTGCCCTACGTCG
TCACTTTTCCCCGTGTGTT -> CACTTTTCCCCGTGTGTTG
TGATGTATTATTAGGTATT -> GATGTATTATTAGGTATTT
ATACGTTACGTTATACGGT -> TACGTTACGTTATACGGTG
CGTTATACGGTGGTGTCCT -> GTTATACGGTGGTGTCCTG
CAGACCGAGTAACATGGGG -> AGACCGAGTAACATGGGGA
GGCTATGATTGAGCGTTTG -> GCTATGATTGAGCGTTTGC
CATCCAGGGAGGACCTACT -> ATCCAGGGAGGACCTACTC
TCTATGCCCGCAAAGGAGA -> CTATGCCCGCAAAGGAGAC
GTTGCCTTTCCAAATGAGG -> TTGCCTTTCCAAATGAGGT
CACTCTCGGGTTCTAAGCT -> ACTCTCGGGTTCTAAGCTT
AGTTACAGCCAATTGCTAA -> GTTACAGCCAATTGCTAAC
TCTTACTTGTTTCGCCGAT -> CTTACTTGTTTCGCCGATC
CATAAAACCTCCAGACGGG -> ATAAAACCTCCAGACGGGG
CTGAGGAACCACTACCCCA -> TGAGGAACCACTACCCCAA
CGGTCTGGACGTTGCCTTT -> GGTCTGGACGTTGCCTTTC
GCAAGCCCGGCAATTCAAG -> CAAGCCCGGCAATTCAAGT
CCGGGAAACTGACTGGATA -> CGGGAAACTGACTGGATAA
TCCCACGAGATCCTGAGCC -> CCCACGAGATCCTGAGCCC
CTAAGGAGACCCATAGCTT -> TAAGGAGACCCATAGCTTC
AATATGGTATAGATGCCGT -> ATATGGTATAGATGCCGTT
GGCAATTCAAGTGAAGGCG -> GCAATTCAAGTGAAGGCGA
TTCACTATGCTACATAAGC -> TCACTATGCTACATAAGCT
AGTCGCCAAATATGGTATA -> GTCGCCAAATATGGTATAG
CTCCGTTCAGACCGAGTAA -> TCCGTTCAGACCGAGTAAC
ATTGACCTCCGTTCAGACC -> TTGACCTCCGTTCAGACCG
CGAGAGTTGTCTATATTGA -> GAGAGTTGTCTATATTGAA
GAGCCCCGACGAGTGTTAG -> AGCCCCGACGAGTGTTAGA
GCCGAGGACTCCACAGGTG -> CCGAGGACTCCACAGGTGC
GTAGCTCAGGGCTTGTTAG -> TAGCTCAGGGCTTGTTAGT
AGGGGATCGCGGCGGACAA -> GGGGATCGCGGCGGACAAG
GGTACTCCTTACAGCGCAA -> GTACTCCTTACAGCGCAAG
GTCGCGGGACTGGATTAAG -> TCGCGGGACTGGATTAAGA
GCTCAGATACGAGCGCCTG -> CTCAGATACGAGCGCCTGA
AAGACGCTAGCTGCAACGA -> AGACGCTAGCTGCAACGAC
AGCCTGTCTCTGTCCCTTC -> GCCTGTCTCTGTCCCTTCA
CGGTGAGTTCACTATGCTA -> GGTGAGTTCACTATGCTAC
AGTATCCATCGGCTGCTAT -> GTATCCATCGGCTGCTATT
TTCACCATCGCGGCAACTC -> TCACCATCGCGGCAACTCT
AGGACCTACTCACTTTTCC -> GGACCTACTCACTTTTCCC
TGACCGACTGGTGCACTAA -> GACCGACTGGTGCACTAAC
CCGTCCTTATTTTGGCAGG -> CGTCCTTATTTTGGCAGGA
GGACACCCGCACCAACCAT -> GACACCCGCACCAACCATA
GCAACTGCGGCATTAGAGA -> CAACTGCGGCATTAGAGAC
AGTTGTCTATATTGAAGTA -> GTTGTCTATATTGAAGTAG
CCTCCGTTCAGACCGAGTA -> CTCCGTTCAGACCGAGTAA
AAGACTCGGTCTGGACGTT -> AGACTCGGTCTGGACGTTG
AGCGTTGAGTTACAGCCAA -> GCGTTGAGTTACAGCCAAT
GATTGAGCGTTTGCCAATA -> ATTGAGCGTTTGCCAATAA
AGATTTTTCCCTCATTGTG -> GATTTTTCCCTCATTGTGA
AGGCTGTCGCTCACCGTGC -> GGCTGTCGCTCACCGTGCC
GCGGTTCACCATCGCGGCA -> CGGTTCACCATCGCGGCAA
GTCGCTCACCGTGCCGTAT -> TCGCTCACCGTGCCGTATC
TTGCTCGTACTTGAGCGCG -> TGCTCGTACTTGAGCGCGT
TCGTACTTGAGCGCGTCCA -> CGTACTTGAGCGCGTCCAA
CAAGTATCCATCGGCTGCT -> AAGTATCCATCGGCTGCTA
CGAGAGTTTCTCCTGTTAG -> GAGAGTTTCTCCTGTTAGC
GGACCGCGCACAGAACATG -> GACCGCGCACAGAACATGA
GGCTGCGTTGTATGTCATT -> GCTGCGTTGTATGTCATTG
CTCAGATACGAGCGCCTGA -> TCAGATACGAGCGCCTGAC
CGAGGACTCCACAGGTGCC -> GAGGACTCCACAGGTGCCA
ATGATTGAGCGTTTGCCAA -> TGATTGAGCGTTTGCCAAT
GACTGGATTAAGAGTCTGA -> ACTGGATTAAGAGTCTGAT
CCGGCGTCATCGTAGTCGC -> CGGCGTCATCGTAGTCGCC
GACCTACTCACTTTTCCCC -> ACCTACTCACTTTTCCCCG
AGGGCTTGTTAGTTGCTAC -> GGGCTTGTTAGTTGCTACA
GCGCGTCCAACGGACCCCG -> CGCGTCCAACGGACCCCGC
TTCAAGTGAAGGCGAAGAA -> TCAAGTGAAGGCGAAGAAG
CGAAGTTATCAGATACTCC -> GAAGTTATCAGATACTCCT
TATGGTATAGATGCCGTTA -> ATGGTATAGATGCCGTTAA
AAGGCGGTCTGCTGATGTA -> AGGCGGTCTGCTGATGTAT
CAGGAATGAGGCATTCCGC -> AGGAATGAGGCATTCCGCC
ACTTCAGGAATGAGGCATT -> CTTCAGGAATGAGGCATTC
CCGGTATCCCTACGATAGA -> CGGTATCCCTACGATAGAG
CTATGATTGAGCGTTTGCC -> TATGATTGAGCGTTTGCCA
GAAGGCGAAGAAGGAGACT -> AAGGCGAAGAAGGAGACTT
AAAGGGGACTTGACCGACT -> AAGGGGACTTGACCGACTG
CCAACGGACCCCGCGATTT -> CAACGGACCCCGCGATTTA
GCAACTCTTGGGTTCAGGA -> CAACTCTTGGGTTCAGGAA
ACCTGCACTGCAACCGGCG -> CCTGCACTGCAACCGGCGT
AGACGCTAGCTGCAACGAC -> GACGCTAGCTGCAACGACA
CCAGATACGGTTCATACCT -> CAGATACGGTTCATACCTT
ATTTAGAGCGGTTCACCAT -> TTTAGAGCGGTTCACCATC
CACGCACCTGCACTGCAAC -> ACGCACCTGCACTGCAACC
AGATCCTGAGCCCACTCCG -> GATCCTGAGCCCACTCCGC
GTTACGGTCGTTTCCGGTC -> TTACGGTCGTTTCCGGTCG
GACCATTAATCCCACGAGA -> ACCATTAATCCCACGAGAT
AGGCATTCCGCCTCTGCCA -> GGCATTCCGCCTCTGCCAA
CATAGGAAGGACCGCGCAC -> ATAGGAAGGACCGCGCACA
TTTGTGCCCGCTTGCCCTC -> TTGTGCCCGCTTGCCCTCC
AGTTGTCCGCTTTTAGCCA -> GTTGTCCGCTTTTAGCCAC
CGCTAATGCTATTTGTATA -> GCTAATGCTATTTGTATAT
CAGGAACCCAGATACGGTT -> AGGAACCCAGATACGGTTC
CTTTAGGACACCCGCACCA -> TTTAGGACACCCGCACCAA
TTGTGCCCGCTTGCCCTCC -> TGTGCCCGCTTGCCCTCCC
TGGCAGGAACCCAGATACG -> GGCAGGAACCCAGATACGG
AGACGACGCTATGTTAGGC -> GACGACGCTATGTTAGGCT
GATACGGTTCATACCTTTA -> ATACGGTTCATACCTTTAC
CCAAATGAGGTCCGCGTAG -> CAAATGAGGTCCGCGTAGG
CGCGTAGGTTTATGGATCT -> GCGTAGGTTTATGGATCTC
TGTCGCTCACCGTGCCGTA -> GTCGCTCACCGTGCCGTAT
CCGTTCAGACCGAGTAACA -> CGTTCAGACCGAGTAACAT
AACCTCCAGACGGGGCTCC -> ACCTCCAGACGGGGCTCCG
TCCGCGCTACTCGACAACC -> CCGCGCTACTCGACAACCG
ACTGCCGGTGCTCCTTTTA -> CTGCCGGTGCTCCTTTTAG
TATGCCCGCAAAGGAGACC -> ATGCCCGCAAAGGAGACCC
CTCACTTTTCCCCGTGTGT -> TCACTTTTCCCCGTGTGTT
AGGAATGAGGCATTCACGA -> GGAATGAGGCATTCACGAG
GGGTCCCGGTGGTGAGAAA -> GGTCCCGGTGGTGAGAAAT
AACGCGGTGAGTTCACTAT -> ACGCGGTGAGTTCACTATG
GTAGTCGCCAAATATGGTA -> TAGTCGCCAAATATGGTAT
AGTCGCGGGACTGGATTAA -> GTCGCGGGACTGGATTAAG
TTTCGAAAAGAACGACTCA -> TTCGAAAAGAACGACTCAA
AGAGTAGCTCATTTACTTT -> GAGTAGCTCATTTACTTTC
TGTCAAGGCGGTCTGCTGA -> GTCAAGGCGGTCTGCTGAT
GCACATTAAGGACGGCGCA -> CACATTAAGGACGGCGCAA
ATTAACAGGACAGCGTTGG -> TTAACAGGACAGCGTTGGC
ACCTCCGTTCAGACCGAGT -> CCTCCGTTCAGACCGAGTA
ACTACCCCAAATATTCAGG -> CTACCCCAAATATTCAGGA
GCTCATTTACTTTCGTTAC -> CTCATTTACTTTCGTTACG
CAACGGACCCCGCGATTTA -> AACGGACCCCGCGATTTAC
ACGGCACTAAGGAGACCCA -> CGGCACTAAGGAGACCCAT
GACCGCGCACAGAACATGA -> ACCGCGCACAGAACATGAA
CCGCACCAACCATAGGAAG -> CGCACCAACCATAGGAAGG
CTTCACCAGCCTGTCTCTG -> TTCACCAGCCTGTCTCTGT
CGACGCTAATGCTATTTGT -> GACGCTAATGCTATTTGTA
TCCTTATTTTGGCAGGAAC -> CCTTATTTTGGCAGGAACC
ACGAGTGTTAGACGACCAT -> CGAGTGTTAGACGACCATT
AACCTGGTACCTAGTTGTC -> ACCTGGTACCTAGTTGTCC
GGGTAGGCGTCTTGACTCT -> GGTAGGCGTCTTGACTCTC
CTATTTGTGCCCGCTTGCC -> TATTTGTGCCCGCTTGCCC
CACCAACCATAGGAAGGAC -> ACCAACCATAGGAAGGACC
CATCAGGGTACAGTTTCTA -> ATCAGGGTACAGTTTCTAT
TCTGCCAAGGAGACCCATA -> CTGCCAAGGAGACCCATAG
AAGTTATCAGATACTCCTT -> AGTTATCAGATACTCCTTC
GATGTAAGCCGTCGTTCTG -> ATGTAAGCCGTCGTTCTGC
GACAGCGTTGGCTCAGATA -> ACAGCGTTGGCTCAGATAC
GACTCGGTCTGGACGTTGC -> ACTCGGTCTGGACGTTGCC
CACGAGATCCTGAGCCCAC -> ACGAGATCCTGAGCCCACT
GGAACCACTACCCCAAATA -> GAACCACTACCCCAAATAT
GAATGAGGCATTCGTACGG -> AATGAGGCATTCGTACGGC
ACTTGACCGACTGGTGCAC -> CTTGACCGACTGGTGCACT
ACTCACTTTTCCCCGTGTG -> CTCACTTTTCCCCGTGTGT
AAAATTACTCTGACTTAGT -> AAATTACTCTGACTTAGTA
CTAAACCTGGTACCTAGTT -> TAAACCTGGTACCTAGTTG
CTTGAGCGCGTCCAACGGA -> TTGAGCGCGTCCAACGGAC
TAGAGCGGTTCACCATCGC -> AGAGCGGTTCACCATCGCG
CGGGACTGGATTAAGAGTC -> GGGACTGGATTAAGAGTCT
TGCCGTGGGCGAGAGTTTC -> GCCGTGGGCGAGAGTTTCT
ACTGACGAGTTACGCTAGT -> CTGACGAGTTACGCTAGTA
GTTGGATTAAAACCGTGCA -> TTGGATTAAAACCGTGCAC
ATAGCTTCATTGTGCGGTG -> TAGCTTCATTGTGCGGTGA
CACGCACATTAAGGACGGC -> ACGCACATTAAGGACGGCG
ACGAGTTACGCTAGTAAGG -> CGAGTTACGCTAGTAAGGA
TAAAAGAGTAGCTCATTTA -> AAAAGAGTAGCTCATTTAC
AGACCCATAGCTTCATTGT -> GACCCATAGCTTCATTGTG
GTAGAGTAAAAGAGTAGCT -> TAGAGTAAAAGAGTAGCTC
TGATTTAGATGACGGTGCC -> GATTTAGATGACGGTGCCC
TTGTCTATATTGAAGTAGG -> TGTCTATATTGAAGTAGGG
TATGATTGAGCGTTTGCCA -> ATGATTGAGCGTTTGCCAA
CTCTCGGGTTCTAAGCTTA -> TCTCGGGTTCTAAGCTTAG
GTGCACCAGACGACGCTAT -> TGCACCAGACGACGCTATG
TCTGCTGATGTATTATTAG -> CTGCTGATGTATTATTAGG
CAGGGAGGAGGGGAGTTCA -> AGGGAGGAGGGGAGTTCAG
GGACAAGTATCCATCGGCT -> GACAAGTATCCATCGGCTG
TTCATTTCGAAAAGAACGA -> TCATTTCGAAAAGAACGAC
TCTCATCAGGGTACAGTTT -> CTCATCAGGGTACAGTTTC
GACTCCACAGGTGCCAGCT -> ACTCCACAGGTGCCAGCTA
GTTTCGCCGATCGATGGCC -> TTTCGCCGATCGATGGCCA
CCCTAAACCTGGTACCTAG -> CCTAAACCTGGTACCTAGT
AATGCTATTTGTATATAGG -> ATGCTATTTGTATATAGGT
CTCAAGCGTATTTTTCATT -> TCAAGCGTATTTTTCATTT
GGACTTGACCGACTGGTGC -> GACTTGACCGACTGGTGCA
GCTGCGTTGTATGTCATTG -> CTGCGTTGTATGTCATTGA
GTCGTTCTGCCGTGGGCGA -> TCGTTCTGCCGTGGGCGAG
CCTTCCGAGAGTTGTCTAT -> CTTCCGAGAGTTGTCTATA
GATCTCAAGACTTGCTACT -> ATCTCAAGACTTGCTACTA
CGTCTTGACTCTCATCAGG -> GTCTTGACTCTCATCAGGG
AGTCTTACTTGTTTCGCCG -> GTCTTACTTGTTTCGCCGA
CGATCGATGGCCAATTACG -> GATCGATGGCCAATTACGT
TCATTTACTTTCGTTACGG -> CATTTACTTTCGTTACGGT
CTTCATAAGACGGCGATGC -> TTCATAAGACGGCGATGCG
CTTCATTTCGAAAAGAACG -> TTCATTTCGAAAAGAACGA
CAAACTGTGGGACTTGGGC -> AAACTGTGGGACTTGGGCC
TCATACCTTTACTCGGTTC -> CATACCTTTACTCGGTTCA
GGGCGAGAGTTTCTCCTGT -> GGCGAGAGTTTCTCCTGTT
CCCTCATCATCCGAATATT -> CCTCATCATCCGAATATTG
CACCTGCACTGCAACCGGC -> ACCTGCACTGCAACCGGCG
CGTGCACCAGACGACGCTA -> GTGCACCAGACGACGCTAT
TTAGTATGTGGTACTCCTT -> TAGTATGTGGTACTCCTTA
TGCTCTGTTACTTCAGGAA -> GCTCTGTTACTTCAGGAAT
CTTGGGTTCAGGAATGAGG -> TTGGGTTCAGGAATGAGGC
CCGATCGATGGCCAATTAC -> CGATCGATGGCCAATTACG
GTCCAACGGACCCCGCGAT -> TCCAACGGACCCCGCGATT
CGCGGACTATTAACAGGAC -> GCGGACTATTAACAGGACA
TTGTTGGATTAAAACCGTG -> TGTTGGATTAAAACCGTGC
CGGTGCTCCTTTTAGCTAC -> GGTGCTCCTTTTAGCTACA
CACCAGCCTGTCTCTGTCC -> ACCAGCCTGTCTCTGTCCC
AGCCCTCCCCCGTCTTTAG -> GCCCTCCCCCGTCTTTAGG
CTGCCGTGGGCGAGAGTTT -> TGCCGTGGGCGAGAGTTTC
TCTGCACTGCCCTAAACCT -> CTGCACTGCCCTAAACCTG
CGTTTCCGGTCGAGACCAA -> GTTTCCGGTCGAGACCAAA
CAAATGAGGTCCGCGTAGG -> AAATGAGGTCCGCGTAGGT
CGCCGACGAGGCTGCGTTG -> GCCGACGAGGCTGCGTTGT
GTGTCCTGGGGTAGGCGTC -> TGTCCTGGGGTAGGCGTCT
CGAATATTGCTATGACGCC -> GAATATTGCTATGACGCCC
CCGACGCTAATGCTATTTG -> CGACGCTAATGCTATTTGT
CATTGACCTCCGTTCAGAC -> ATTGACCTCCGTTCAGACC
CGTAGCAACTGCGGCATTA -> GTAGCAACTGCGGCATTAG
TACCTAGTTGTCCGCTTTT -> ACCTAGTTGTCCGCTTTTA
CAGTGGCCGAGGACTCCAC -> AGTGGCCGAGGACTCCACA
TCCACCACATGGTCATCCA -> CCACCACATGGTCATCCAG
ACGGTTCATACCTTTACTC -> CGGTTCATACCTTTACTCG
ATTCAGGAATGAGGCATTC -> TTCAGGAATGAGGCATTCA
ATGAGGCATTCCGCCTCTG -> TGAGGCATTCCGCCTCTGC
GCTAGCTGCAACGACACCC -> CTAGCTGCAACGACACCCG
GGTTTGACGGTAGCTCAGG -> GTTTGACGGTAGCTCAGGG
GTGAGTTCACTATGCTACA -> TGAGTTCACTATGCTACAT
CTCCCTCATCATCCGAATA -> TCCCTCATCATCCGAATAT
GATGCCGTTAATAGCGCAG -> ATGCCGTTAATAGCGCAGT
CATAGCTTCATAAAACCTC -> ATAGCTTCATAAAACCTCC
TATTAGGTATTTCAGGAAT -> ATTAGGTATTTCAGGAATG
GCGGTGAGTTCACTATGCT -> CGGTGAGTTCACTATGCTA
GACGAGTTACGCTAGTAAG -> ACGAGTTACGCTAGTAAGG
GTTAGACGACCATTAATCC -> TTAGACGACCATTAATCCC
ATCCCACGAGATCCTGAGC -> TCCCACGAGATCCTGAGCC
GTTAGTTGCTACACTCTCG -> TTAGTTGCTACACTCTCGG
CGTCATCGTAGTCGCCAAA -> GTCATCGTAGTCGCCAAAT
CGACAACCGACGCTAATGC -> GACAACCGACGCTAATGCT
CCGTCGTTCTGCCGTGGGC -> CGTCGTTCTGCCGTGGGCG
CACCATCGCGGCAACTCTT -> ACCATCGCGGCAACTCTTG
GTGGGACTTGGGCCTTGAC -> TGGGACTTGGGCCTTGACG
CCAATTGCTAACGGGACCC -> CAATTGCTAACGGGACCCC
GAACCCAGATACGGTTCAT -> AACCCAGATACGGTTCATA
TGCCTTTCCAAATGAGGTC -> GCCTTTCCAAATGAGGTCC
CTTTGAATAGCGTTGAGTT -> TTTGAATAGCGTTGAGTTA
GGGTTCAGGAATGAGGCAT -> GGTTCAGGAATGAGGCATT
ATTAAGGAGACCCATAGCT -> TTAAGGAGACCCATAGCTT
TCATTGACCTCCGTTCAGA -> CATTGACCTCCGTTCAGAC
AAGGACCGCGCACAGAACA -> AGGACCGCGCACAGAACAT
CGAACTGCTCTGTTACTTC -> GAACTGCTCTGTTACTTCA
AGATCACGCACCTGCACTG -> GATCACGCACCTGCACTGC
CTGCTCTGTTACTTCAGGA -> TGCTCTGTTACTTCAGGAA
CGGAGCCCCGACGAGTGTT -> GGAGCCCCGACGAGTGTTA
GTTGTATGTCATTGACCTC -> TTGTATGTCATTGACCTCC
TTTTCATTTGTTGGATTAA -> TTTCATTTGTTGGATTAAA
AGTAAGGAGCTTCGAACTG -> GTAAGGAGCTTCGAACTGC
AGAGCGGTTCACCATCGCG -> GAGCGGTTCACCATCGCGG
CCGAATATTGCTATGACGC -> CGAATATTGCTATGACGCC
TCCGGCGCGGACTATTAAC -> CCGGCGCGGACTATTAACA
GGACCGGTATCCCTACGAT -> GACCGGTATCCCTACGATA
CGATGGCCAATTACGTGGA -> GATGGCCAATTACGTGGAG
GAACAAGGGGATCGCGGCG -> AACAAGGGGATCGCGGCGG
GAATAGCGTTGAGTTACAG -> AATAGCGTTGAGTTACAGC
CACAGTGGCCGAGGACTCC -> ACAGTGGCCGAGGACTCCA
GGTCTGCTGATGTATTATT -> GTCTGCTGATGTATTATTA
TCTGGACGTTGCCTTTCCA -> CTGGACGTTGCCTTTCCAA
TTGCCCACATTGCACGTCT -> TGCCCACATTGCACGTCTC
GTATTTCAGGAATGAGGCA -> TATTTCAGGAATGAGGCAT
TACTTCAGGAATGAGGCAT -> ACTTCAGGAATGAGGCATT
ACAGTTTCTATAATACCAT -> CAGTTTCTATAATACCATT
TACCATTGGATACTTAGTT -> ACCATTGGATACTTAGTTC
TACTTGAGCGCGTCCAACG -> ACTTGAGCGCGTCCAACGG
CGTTACGGTCGTTTCCGGT -> GTTACGGTCGTTTCCGGTC
AGCGTTGGCTCAGATACGA -> GCGTTGGCTCAGATACGAG
TACTCCTTCCCGGGGTCCC -> ACTCCTTCCCGGGGTCCCG
GAAAAGGGGACTTGACCGA -> AAAAGGGGACTTGACCGAC
GTGGGCGAGAGTTTCTCCT -> TGGGCGAGAGTTTCTCCTG
GCGTCTTGACTCTCATCAG -> CGTCTTGACTCTCATCAGG
AGCGCCTGACGCCTCGCGG -> GCGCCTGACGCCTCGCGGA
GCAGTCTTACTTGTTTCGC -> CAGTCTTACTTGTTTCGCC
TCGTTTCCGGTCGAGACCA -> CGTTTCCGGTCGAGACCAA
GGTTCATACCTTTACTCGG -> GTTCATACCTTTACTCGGT
GACGGCGCAACAGACCAAG -> ACGGCGCAACAGACCAAGA
GGGGAGTTCAGGATTTAGA -> GGGAGTTCAGGATTTAGAG
CCAGACGACGCTATGTTAG -> CAGACGACGCTATGTTAGG
GGGAACATGCTTGCTGTCC -> GGAACATGCTTGCTGTCCG
GACCCATAGCTTCATAAGA -> ACCCATAGCTTCATAAGAC
CCTTTACTCGGTTCACCCT -> CTTTACTCGGTTCACCCTT
TACGGTGGTGTCCTGGGGT -> ACGGTGGTGTCCTGGGGTA
GGACCTACTCACTTTTCCC -> GACCTACTCACTTTTCCCC
TAGCCACTAGGCCTCTTGC -> AGCCACTAGGCCTCTTGCT
TGACGCCCTCAATGTCAAG -> GACGCCCTCAATGTCAAGG
TCATCCAGGGAGGACCTAC -> CATCCAGGGAGGACCTACT
TCGATGATGTAAGCCGTCG -> CGATGATGTAAGCCGTCGT
AGACCGAGTAACATGGGGA -> GACCGAGTAACATGGGGAA
ACTAACTGTAAAGACTCGG -> CTAACTGTAAAGACTCGGT
TATTATTAGGTATTTCAGG -> ATTATTAGGTATTTCAGGA
AGACCCATAGCTTCATAAG -> GACCCATAGCTTCATAAGA
CTACTCGACAACCGACGCT -> TACTCGACAACCGACGCTA
CCAATAAAATTACTCTGAC -> CAATAAAATTACTCTGACT
CTGGGGTAGGCGTCTTGAC -> TGGGGTAGGCGTCTTGACT
GACGGTGCCCTACGTCGAT -> ACGGTGCCCTACGTCGATG
GGCGTCTTGACTCTCATCA -> GCGTCTTGACTCTCATCAG
CGAGTGTTAGACGACCATT -> GAGTGTTAGACGACCATTA
CGAGCGCCTGACGCCTCGC -> GAGCGCCTGACGCCTCGCG
GGACTCCACAGGTGCCAGC -> GACTCCACAGGTGCCAGCT
TCGGGTTCTAAGCTTAGCG -> CGGGTTCTAAGCTTAGCGT
GCGTTAGCTAGTTGCCCAC -> CGTTAGCTAGTTGCCCACA
TACGTCGATGATGTAAGCC -> ACGTCGATGATGTAAGCCG
CATGGTCATCCAGGGAGGA -> ATGGTCATCCAGGGAGGAC
CTTTACTCGGTTCACCCTT -> TTTACTCGGTTCACCCTTC
AACTGCTCTGTTACTTCAG -> ACTGCTCTGTTACTTCAGG
TTACTTTCGTTACGGTCGT -> TACTTTCGTTACGGTCGTT
TCATCAGGGTACAGTTTCT -> CATCAGGGTACAGTTTCTA
TTATTAAGGAGACCCATAG -> TATTAAGGAGACCCATAGC
GTTACGTTATACGGTGGTG -> TTACGTTATACGGTGGTGT
GGAATGAGGCATTCACGAG -> GAATGAGGCATTCACGAGT
AAACTGACTGGATAAGATC -> AACTGACTGGATAAGATCA
AGAAAAGTGATAGAGTAGA -> GAAAAGTGATAGAGTAGAG
TCCGGAACGCGGTGAGTTC -> CCGGAACGCGGTGAGTTCA
TCTCTGTCCCTTCACTGCC -> CTCTGTCCCTTCACTGCCG
TCTTGGGTTCAGGAATGAG -> CTTGGGTTCAGGAATGAGG
TCATTGTGAGTCTTTGAAT -> CATTGTGAGTCTTTGAATA
GTTCATACCTTTACTCGGT -> TTCATACCTTTACTCGGTT
GGTAGGCGTCTTGACTCTC -> GTAGGCGTCTTGACTCTCA
GGGCTCCGGAACGCGGTGA -> GGCTCCGGAACGCGGTGAG
CACCCTTCCGAGAGTTGTC -> ACCCTTCCGAGAGTTGTCT
ACGCTAATGCTATTTGTAT -> CGCTAATGCTATTTGTATA
ATCCCTACGATAGAGGATC -> TCCCTACGATAGAGGATCA
CTTAGTATGTGGTACTCCT -> TTAGTATGTGGTACTCCTT
ACGAGGCTGCGTTGTATGT -> CGAGGCTGCGTTGTATGTC
GGTTCAGGAATGAGGCATT -> GTTCAGGAATGAGGCATTC
CGAGTTATTAAGGAGACCC -> GAGTTATTAAGGAGACCCA
TCCTGGAACAAGGGGATCG -> CCTGGAACAAGGGGATCGC
ATGACGCCCTCAATGTCAA -> TGACGCCCTCAATGTCAAG
